confidential	/,kɔnfi'denʃəl/	a.秘(机)密的;表示信任的;担任机密工作的\r\n
confine	/kən'fain,'kɔnfain/	vt.限制;使不外出,禁闭n./pl./界限,范围\r\n
confirm	/kən'fə:m/	v.使更坚固,使更坚定;(进一步)证实;确认\r\n
conflict	/kən'flikt,'kɔnflikt/	n.战斗,斗争;抵触,冲突v.(with)抵触,冲突\r\n
conform	/kən'fɔ:m/	vi.(to)遵守,适应;相似,一致,符合\r\n
confront	/kən'frʌnt/	v.使面临,使遭遇;面对(危险等)\r\n
confuse	/kən'fju:z/	v.使混乱,混淆\r\n
confusion	/kən'fju:ʒən/	n.困惑,糊涂;混淆;混乱,骚乱\r\n
congratulate	/kən'ɡrætʃu,leit/	v.(on)祝贺,向…致贺词\r\n
congratulation	/kən,ɡrætʃu'leiʃən/	n.(on)祝贺,(pl.)祝贺词\r\n
congress	/'kɔŋɡres,kən'ɡres/	n.(代表)大会;(美国等国的)国会,议会\r\n
conjunction	/kən'dʒʌŋkʃən/	n.接合,连接,联合;连(接)词\r\n
connect	/kə'nekt/	vt.连接;与…联系,接通(电话)vi.连接\r\n
connection	/kə'nekʃən/	n.(connexion)联系,连接;亲戚,社会关系\r\n
conquer	/'kɔŋkə/	v.征服,战胜,占领;克服,破除(坏习惯等)\r\n
conquest	/'kɔŋkwest/	n.征服,征服地,掠取物\r\n
conscience	/'kɔnʃəns/	n.良心,良知\r\n
conscientious	/,kɔnʃi'enʃəs/	a.审慎正直的,认真的,本着良心的\r\n
conscious	/'kɔnʃəs/	a.(of)意识到的,自觉的;神志清醒的\r\n
consecutive	/kən'sekjutiv/	a.连续的;连贯的;顺序的\r\n
consensus	/kən'sensəs/	n.(意见等的)一致,一致同意,共识\r\n
consent	/kən'sent/	v./n.(to)同意,赞成,答应\r\n
consequence	/'kɔnsi,kwəns/	n.结果,后果,影响;重要性\r\n
consequently	/'kɔnsi,kwəntli/	ad.结果,因此,所以\r\n
conservation	/,kɔnsə'veiʃən/	n.保存,保护,保守;守恒,不灭\r\n
conservative	/kən'sə:vətiv/	a.保守的,守旧的n.保守主义者\r\n
consider	/kən'sidə/	v.考虑,细想;体谅,顾及;认为,把…看作\r\n
considerable	/kən'sidərəbl/	a.相当大(或多)的,可观的;值得考虑的\r\n
considerate	/kənˈsɪdərət/	a.考虑周到的,体谅的\r\n
consideration	/kən,sidə'reiʃən/	n.需要考虑的事,理由;考虑,思考;体谅,照顾\r\n
consist	/kən'sist/	v.(in)在于,存在于;(of)由…组成,由…构成\r\n
consistent	/kən'sistənt/	a.(in)前后一致的;（with）一致,符合\r\n
console	/kən'səul/	n.控制台,仪表板;落地柜vt.安慰,慰问\r\n
consolidate	/kən'sɔlideit/	v.使加固,使加强;(把...)联为一体,合并\r\n
conspicuous	/kən'spikjuəs/	a.显眼的,明显的\r\n
conspiracy	/kən'spirəsi/	n.阴谋,密谋,共谋\r\n
constant	/'kɔnstənt/	a.固定的,持续的,忠实的n.常数,恒量\r\n
constituent	/kən'stitjuənt/	n.选民;成分,组分a.组成的,构成的\r\n
constitute	/'kɔnstitju:t/	vt.组成,构成,形成;设立,建立,任命\r\n
constitution	/,kɔnsti'tju:ʃən/	n.构成,构造,组成(方式),成分;体格;宪法\r\n
constrain	/kən'strein/	vt.限制,约束;克制,抑制\r\n
construct	/kən'strʌkt/	v.建设,建造,构造;创立\r\n
construction	/kən'strʌkʃən/	n.建造,构造;建筑物,结构;释义,解释\r\n
consult	/kɔn'sʌlt,'kɔnsʌlt/	v.请教,向...咨询,找...商量;查阅,查看\r\n
consultant	/kən'sʌltənt/	n.会诊医师,顾问医生;顾问\r\n
consume	/kən'sju:m/	vt.消耗;吃完,喝光;(with)使着迷;烧毁\r\n
consumption	/kən'sʌmpʃən/	n.消费(量),消耗\r\n
contact	/'kɔntækt,kən'tækt/	v./n.(使)接触,联系,交往\r\n
contain	/kən'tein/	v.包含,容纳;容忍,抑制;可被...除尽\r\n
container	/kən'teinə/	n.容器;集装箱\r\n
contaminate	/kən'tæmi,neit/	v.弄污,弄脏,毒害,传染,染污\r\n
contemplate	/'kɔntəm,pleit/	vt.盘算,计议;周密考虑;注视,凝视\r\n
contemporary	/kən'tempərəri/	a.现代的,当代的;同时代的\r\n
contempt	/kən'tempt/	n.轻视,藐视;受辱,丢脸\r\n
contend	/kən'tend/	v.竞争,斗争;坚决主张\r\n
content	/'kɔntent/	n.容量,内容,(pl.)目录a.(with)满足的\r\n
contest	/'kɔntest,kən'test/	n.竞争,竞赛,比赛v.竞争,比赛,争论\r\n
context	/'kɔntekst/	n.（文章等）前后关系;(事件等发生的)背景\r\n
continent	/'kɔntinənt/	n.大陆,洲\r\n
continual	/kən'tinjuəl/	a.不断的,连续的,频繁的\r\n
continue	/kən'tinju:/	v.继续,连续,延伸\r\n
continuous	/kən'tinjuəs/	a.连续的,持续的\r\n
contract	/'kɔntrækt,kən'trækt/	n.(承包)合同/契约v.订合同/契约;使缩小\r\n
contradict	/,kɔntrə'dikt/	v.反驳;同…矛盾,同…抵触\r\n
contradiction	/,kɔntrə'dikʃən/	n.反驳,否认;矛盾,不一致\r\n
contrary	/'kɔntrəri/	a.(to)相反的,矛盾的n.反对,矛盾;相反\r\n
contrast	/kən'trɑ:st,-'træst/	n.对比,对照vi.形成对比vt.把…与…对比\r\n
contribute	/kən'tribju:t/	v.(to)贡献,捐助,捐献;投稿\r\n
contribution	/,kəntri'bju:ʃən/	n.贡献;捐款,捐献物;投稿\r\n
contrive	/kən'traiv/	vt.谋划,策划;设法做到;设计,想出\r\n
control	/kən'trəul/	n.(over)控制,支配v.控制,支配\r\n
controversial	/,kɔntrə'və:ʃəl/	a.引起争论的,有争议的\r\n
controversy	/'kɔntrə,və:si/	n.争论,辩论,争吵\r\n
convenience	/kən'vi:njəns/	n.便利,方便;(pl.)便利设备\r\n
convenient	/kən'vi:njənt/	a.(to)便利的,方便的\r\n
convention	/kən'venʃən/	n.大会,会议;惯例,常规,习俗;公约,协定\r\n
conventional	/kən'venʃənəl/	a.惯例的,常规的\r\n
conversation	/,kɔnvə'seiʃən/	n.会话,谈话\r\n
conversely	/ˈkɒnvɜːsli/	ad.相反地\r\n
conversion	/kən'və:ʃən/	n.转变,转换;信仰的改变;\r\n
convert	/kən'və:t/	v.变换,转换;改变（信仰等）;兑换（钱）\r\n
convey	/kən'vei/	v.运送,搬运,转运;传达,传播\r\n
convict	/kən'vikt/	v.(经审讯)证明…有罪,宣判…有罪n.囚犯\r\n
conviction	/kən'vikʃən/	n.深信,确信;定罪,判罪;\r\n
convince	/kən'vins/	v.(of)使信服,使确信\r\n
cook	/kuk/	n.厨师v.烹调,烧煮;纂改(账目),捏造\r\n
cool	/ku:l/	a.凉的;冷静的n.凉快ad.冷静地v.使变凉\r\n
cooperate	/kəu'ɔpəreit/	v.(with)合作,协作,相配合\r\n
cooperative	/kəu'ɔpərətiv/	a.合作的,协作的n.合作社\r\n
coordinate	/kəu'ɔ:dineit/	a.同等的,并列的;坐标的n.坐标\r\n
coordinates	/kəu'ɔ:dineits/	a.同等的n.同等者,坐标vt.协作,协调\r\n
cop	/kɒp/	n.警察(slang俚语)\r\n
cope	/kəup/	v.(with)竞争,对抗;(with)对付,妥善处理\r\n
copper	/'kɔpə/	n.铜;铜币,铜制器\r\n
copy	/'kɔpi/	n.抄本,摹本;(一)本vt.抄写;考试中抄袭\r\n
copyright	/'kɔpi,rait/	n.／a.版权(的)\r\n
cord	/kɔ:d/	n.绳,索\r\n
cordial	/'kɔ:djəl/	a.诚恳的,亲切的,热诚的\r\n
core	/kɔ:/	n.果核;中心,核心\r\n
corn	/kɔ:n/	n.谷物,庄稼,玉米\r\n
corner	/'kɔ:nə/	n.角,街角;偏僻处;vt.将…逼入困境;\r\n
corporation	/,kɔ:pə'reiʃən/	n.市镇自治机关;法人;公司,企业\r\n
correct	/kə'rekt/	a.正确的,恰当的,端正的v.改正,纠正,矫正\r\n
correlate	/'kɔ:rə,leit/	n.相互关联的事物v.(with,to)(使)互相关联\r\n
correspond	/,kɔ:ri'spɔnd/	v.通信,(with)符合,一致;(to)相当于,对应\r\n
correspondence	/,kɔ:ris'pɔndəns/	n.通信,信件;(with)符合;(to)相当于,对应\r\n
correspondent	/,kɔ:ri'spɔndənt/	n.记者,通讯员;通信者\r\n
corresponding	/,kɔ:ri'spɔndiŋ/	a.符合的,相应的,对应的\r\n
corridor	/'kɔridɔ:/	n.走廊,通道\r\n
corrode	/kə'rəud/	v.(受)腐蚀,侵蚀\r\n
corrupt	/kə'rʌpt/	v.贿赂,收买a.腐败的,贪污的\r\n
cosmic	/'kɔzmik/	a.宇宙的;无比巨大的,无穷尽的\r\n
cost	/kɔst/	n.成本,费用,代价v.价值为,花费\r\n
costly	/'kɔstli/	a.昂贵的,价值高的,豪华的\r\n
costume	/'kɔstju:m,kɔ'stju:m/	n.(流行的)服饰;戏装,(特定场合的)套装\r\n
cosy	/'kəuzi/	a.暖和舒服的;舒适的/反/uncomfortable\r\n
cottage	/'kɔtidʒ/	n.村舍,小屋,别墅\r\n
cotton	/'kɔtən/	n.棉花;棉线,棉纱;棉制品\r\n
couch	/kautʃ/	n.长沙发;(病人躺的)长榻vt.表达\r\n
cough	/kɔ:f/	v./n.咳嗽\r\n
could	/强kud,弱kəd/	v.aux.(口语)(表示许可或请求）可以...,行\r\n
council	/'kaunsəl/	n.理事会,委员会,议事机构\r\n
counsel	/'kaunsəl/	v./n.劝告,忠告n.法律顾问,辩护人\r\n
count	/kaunt/	v.数,计算;算入;看作,认为n.计数,总数\r\n
counter	/'kauntə/	n.柜台;计数器a./ad.相反(的)v.反对,反击\r\n
counterpart	/'kauntə,pɑ:t/	n.对应的人(或物)\r\n
country	/'kʌntri/	n.国家;农村,乡下\r\n
countryside	/'kʌntri,said/	n.乡下,农村\r\n
county	/'kaunti/	n.(英国)郡,(美国)县\r\n
couple	/'kʌpl/	n.(一)对,双;夫妇;v.连接,结合\r\n
coupon	/'ku:pɔn/	n.证明持券人有某种权利的卡片,票证,赠券\r\n
courage	/'kʌridʒ/	n.勇气,胆量\r\n
course	/kɔ:s/	n.课程,教程;过程,进程;路程,路线;一道菜\r\n
court	/kɔ:t/	n.法院,法庭;宫廷,朝廷;院子;球场\r\n
courtesy	/'kə:tisi/	n.谦恭有礼;有礼貌的举止(或言词)\r\n
courtyard	/'kɔ:t,jɑ:d/	n.院子,庭院,天井\r\n
cousin	/'kʌzən/	n.堂(或表)兄弟,堂(或表)姐妹\r\n
cover	/'kʌvə/	v.覆盖,包括,涉及n.盖子,套子;(书的)封面\r\n
cow	/kau/	n.母牛,奶牛\r\n
coward	/'kauəd/	n.懦夫,胆怯者\r\n
crab	/kræb/	n.螃蟹,蟹肉\r\n
crack	/kræk/	n.裂纹,缝隙;破裂声v.(使)破裂,砸开\r\n
cradle	/'kreidl/	n.摇篮;发源地\r\n
craft	/krɑ:ft,kræft/	n.工艺,手艺,技巧;飞机,飞船\r\n
crane	/krein/	n.起重机,鹤\r\n
crash	/kræʃ/	v./n.碰撞,坠落,摔坏n.失败,瓦解;爆裂声\r\n
crawl	/krɔ:l/	v./n.爬行,蠕动;缓慢(的)行进\r\n
crazy	/'kreizi/	a.疯狂的,古怪的,蠢的;(about)狂热的\r\n
cream	/kri:m/	n.乳脂,(鲜)奶油;奶油色\r\n
create	/kri'eit/	v.创造,创作;引起,造成,建立\r\n
creative	/kri'eitiv/	a.有创造力的,创造性的\r\n
creature	/'kri:tʃə/	n.人,动物;生物\r\n
credential	/kri'denʃəl/	n.凭证,(pl.)国书,证明书\r\n
credit	/'kredit/	v./n.信用,信任n.信用贷款,赊欠;名誉,名望\r\n
creep	/kri:p/	v.爬,爬行;(植物)蔓延\r\n
crew	/kru:/	n.全体船员,全体乘务员\r\n
cricket	/'krikit/	n.板球;蟋蟀\r\n
crime	/kraim/	n.罪行,犯罪\r\n
criminal	/'kriminəl/	n.罪犯,刑事犯a.犯罪的,刑事的\r\n
cripple	/'kripl/	n.跛子,残疾人v.使跛,使残疾\r\n
crisis	/'kraisis/	n.(pl.crises)危机,紧要关头\r\n
crisp	/krisp/	a.脆的,易碎的;简明扼要的;（空气）清爽的\r\n
criterion	/krai'tiəriən/	n.(pl.criteria或criterions)标准,尺度\r\n
critic	/'kritik/	n.批评家,评论家\r\n
critical	/'kritikəl/	a.批评的,评论的;危急,紧要的;临界的\r\n
criticism	/'kriti,sizəm/	n.评论性的文章,评论;批评,指责,非难\r\n
criticize	/'kriti,saiz/	v.(criticise)批评,评论\r\n
crop	/krɔp/	n.作物,庄稼;(谷类等的)一熟收成;一批,大量\r\n
cross	/krɔ:s/	n.十字(架);苦难a.交叉的;发怒的v.穿过\r\n
crown.乌鸦v.	/n.鸡啼,鸣叫\r\n
crowd	/kraud/	n.人群;一群,一伙v.聚集,群集;挤满,拥挤\r\n
crown	/kraun/	n.王冠,冕;君权,君王v.为…加冕\r\n
crucial	/'kru:ʃəl/	a.至关重要的,决定性的\r\n
crude	/kru:d/	a.天然的,未加工的;未熟的;粗鲁的,粗野的\r\n
cruel	/'kru:əl/	a.残忍的,残酷的\r\n
cruise	/kru:z/	v.巡航;以节省燃料的速度前进n.乘船巡游\r\n
crush	/krʌʃ/	n./v.压碎,压坏v.压服,压垮\r\n
crust	/krʌst/	n.外皮,壳;地壳\r\n
cry	/krai/	n.&v.叫,喊,哭;(鸟兽)叫,啼,鸣,嗥\r\n
crystal	/'kristəl/	n.水晶,水晶饰品;结晶a.水晶的,透明的\r\n
cube	/kju:b/	n.立方形,立方体;立方,三次幂\r\n
cucumber	/'kju:kʌmbə/	n.黄瓜\r\n
cue	/kju:/	暗示,提示,球杆\r\n
cultivate	/'kʌltiveit/	v.耕作,栽培,养殖;培养,教养,磨炼\r\n
culture	/'kʌltʃə/	n.文化,文明;修养;耕种;栽培,培育;\r\n
cunning	/'kʌniŋ/	a./n.狡猾(的),狡诈(的)\r\n
cup	/kʌp/	n.杯子;奖杯,优胜杯;(一)杯,一杯的容量\r\n
cupboard	/'kʌbəd/	n.碗柜,小橱\r\n
curb	/kə:b/	n.路边,场外证券市场,vt.制止,抑制\r\n
cure	/kjuə/	v.(of)治愈,医治;矫正n.治愈,痊愈;良药\r\n
curiosity	/,kjuri'ɔsiti/	n.好奇心;古董,古玩\r\n
curious	/'kjuəriəs/	a.好奇的,求知的,古怪的,爱挑剔的\r\n
curl	/kə:l/	v.(使)卷曲,蜷缩n.卷发;卷曲状;卷曲物\r\n
currency	/'kərənsi/	n.流传,流通;通货,货币\r\n
current	/'kʌrənt/	n.电流,水流;潮流,趋势a.当前的;流通的\r\n
curriculum	/kə'rikjuləm/	n.(pl.curricula)课程,(学校等的)全部课程\r\n
curse	/kə:s/	n.诅咒,咒语,祸因vt.诅咒,咒骂,使受罪\r\n
curtain	/'kə:tən/	n.窗帘,门帘;幕(布);结束;vt遮掩\r\n
curve	/kə:v/	n.曲线,弯曲(物)v.弄弯,成曲形\r\n
cushion	/'kuʃən/	n.垫子,软垫vt.装垫子;缓和,减轻;\r\n
custom	/'kʌstəm/	n.习惯,风俗,惯例;(pl.)海关,关税\r\n
customary	/'kʌstə,məri/	a.习惯的,惯例的\r\n
customer	/'kʌstəmə/	n.顾客,主顾\r\n
cut	/kʌt/	n./v.切,割,削;削减,删节n.切口,伤口\r\n
cyberspace	/'saibə,speis/	n.虚拟信息空间;网络空间\r\n
cycle	/'saikl/	n.自行车;周期,循环v.骑自行车;循环\r\n
cylinder	/'silində/	n.圆筒,圆锥体;汽缸\r\n
daily	/'deili/	a.每日的ad.每日,天天n.日报\r\n
dairy	/'dεəri/	n.牛奶场,奶店\r\n
dam	/dæm/	n.水坝,水闸\r\n
damage	/'dæmidʒ/	v./n.损害,毁坏n.(pl.)损害赔偿费\r\n
damn	/dæm/	int.该死vt.遣责;使失败a.十足的ad.极\r\n
damp	/dæmp/	n.潮湿a.潮湿的vt.使潮湿;使衰减\r\n
dance	/dɑ:ns,dæns/	n.舞(蹈);舞曲,舞会v.跳舞;跳动\r\n
danger	/'deindʒə/	n.危险;威胁;危险事物\r\n
dangerous	/'deindʒərəs/	a.危险的,不安全的\r\n
dare	/dεə/	v.敢,胆敢\r\n
dark	/'dɑ:k/	a.黑暗的,深(色)的;隐秘的;n.无光,黑暗\r\n
darling	/'dɑ:liŋ/	n.心爱的人,亲爱的\r\n
dash	/dæʃ/	v./n.冲,猛冲,突进n.破折号\r\n
data	/'deitə/	n.(datum的复数)资料,数据\r\n
database	/'deitəbeis/	n.(databank)数据库\r\n
date	/deit/	n.日期,年代v.注明…的日期n./v.约会\r\n
daughter	/'dɔ:tə/	n.女儿\r\n
dawn	/dɔ:n/	n.黎明,拂晓v.破晓;开始现出\r\n
day	/dei/	n.天,一昼夜;白昼,白天;时期,时代\r\n
daylight	/'deilait/	n.日光,白昼,黎明\r\n
daytime	/'deitaim/	n.白天,日间\r\n
dazzle	/'dæzl/	v.使惊奇,使倾斜;耀(眼)n.耀眼的光\r\n
dead	/ded/	a.死的;无生命的;死气沉沉的ad.完全地\r\n
deadline	/'dedlain/	n.最后期限\r\n
deadly	/'dedli/	a.致命的;势不两立的;极度的;必定的\r\n
deaf	/def/	a.聋的;不愿听的\r\n
deal	/di:l/	v.处理;做买卖,经营;分配;对待n.交易\r\n
dealer	/'di:lə/	n.商人\r\n
dean	/diːn/	n.(大学)院长;主持牧师;(基督教)教长\r\n
dear	/diə/	a.昂贵的;亲爱的;珍贵的int.呵！哎呀！\r\n
death	/deθ/	n.死,死亡;灭亡,毁灭,死因\r\n
debate	/di'beit/	v./n.争论,辩论\r\n
debt	/det/	n.债,债务\r\n
decade	/'dekeid/	n.十年\r\n
decay	/di'kei/	v./n.腐朽,腐烂;衰减,衰退\r\n
deceit	/di'si:t/	n.欺骗,欺骗行为\r\n
deceive	/di'si:v/	v.欺骗,蒙蔽\r\n
December	/dɪˈsembə(r)/	n.十二月\r\n
decent	/'di:sənt/	a.体面的;正派的,合乎礼仪的;合适的\r\n
decide	/di'said/	v.决定,下决心;解决,裁决\r\n
decimal	/'desiməl/	a.十进的,小数的,十进制的n.小数\r\n
decision	/di'siʒən/	n.决定,决心;决议;决策\r\n
decisive	/di'saisiv/	a.决定性的\r\n
deck	/dek/	n.甲板\r\n
declaration	/,deklə'reiʃən/	n.宣言,宣布,声明\r\n
declare	/di'klεə/	v.宣布,宣告,声明;断言,宣称\r\n
decline	/di'klain/	v.下降,衰落;拒绝n.下降;斜面,倾斜,衰落\r\n
decorate	/'dekəreit/	v.装饰,装璜,布置\r\n
decrease	/di'kri:s/	n.减少,减小;减少量v.减少,变少,降低\r\n
dedicate	/'dedikeit/	vt.奉献;献身于\r\n
deduce	/di'dju:s/	vt.(from)演绎,推断,推论\r\n
deduct	/di'dʌkt/	vt.扣除;演绎(推理)\r\n
deed	/di:d/	n.行为,行动;功绩,事迹;证书;契据\r\n
deem	/di:m/	v.认为,相信\r\n
deep	/di:p/	a.深的,深长的;深奥的;强烈的ad.深入的,迟\r\n
deer	/diə/	n.鹿\r\n
defeat	/di'fi:t/	n.击败,战胜,失败v.击败,战胜;使失败\r\n
defence	/di'fens/	n.(defense)防御,保卫;防务工事;辩护\r\n
defect	/'di:fekt/	n.过失;缺点;不足\r\n
defend	/di'fend/	v.防守,保卫;为…辩护,为…答辩\r\n
deficiency	/di'fiʃənsi/	n.缺乏,不足;缺点,缺陷\r\n
deficit	/'defisit/	n.赤字,逆差;亏损,亏空;不足,缺乏\r\n
define	/di'fain/	v.给…下定义;阐述;阐释;限定,规定\r\n
definite	/'definit/	a.明确的;一定的;意志坚强的,立场坚定的\r\n
definition	/,difi'niʃən/	n.定义,解释;(轮廓影像等的)清晰度;阐明;\r\n
defy	/di'fai,'di:-/	v.(公然)违抗,反抗;蔑视\r\n
degenerate	/di'dʒenəreit/	v.衰退,堕落,蜕化a.堕落的n.堕落者\r\n
degree	/di'ɡri:/	n.程度;度数;学位;等级\r\n
delay	/di'lei/	v./n.耽搁,延迟\r\n
delegate	/'deliɡət/	n.代表vt.委派…为代表;授权;委托\r\n
delete	/di'li:t/	vt.删除\r\n
deliberate	/di'libərət/	a.深思熟虑的,故意的vt.研讨,商讨\r\n
delicate	/'delikət/	a.纤弱的;精致的;微妙的;灵敏的\r\n
delicious	/di'liʃəs/	a.美味的;美妙的;使人愉快的\r\n
delight	/di'lait/	n.快乐,高兴v.(使)高兴,(使)欣喜\r\n
deliver	/di'livə/	v.交付,递送;发表,表达;释放;接生\r\n
delivery	/di'livəri/	n.递送;交付;分娩;交货;引渡\r\n
demand	/di'mɑ:nd,-'mænd/	n./v.要求,请求,需要(量)v.查问\r\n
democracy	/di'mɔkrəsi/	n.民主,民主制,民主国家\r\n
democratic	/,demə'krætik,-kəl/	a.民主的\r\n
demonstrate	/'demənstreit/	v.论证,证实;演示,说明\r\n
denial	/di'naiəl/	n.否认;拒绝;否认某事或某事实的声明\r\n
denote	/di'nəut/	vt.表示,意味着\r\n
denounce	/di'nauns/	vt.公开指责,公然抨击;谴责\r\n
dense	/dens/	a.浓厚的,密集的,稠密的\r\n
density	/'densəti/	n.密集,密度,浓度\r\n
dental	/'dentəl/	a.牙齿的;牙科(用)的\r\n
dentist	/'dentist/	n.牙医\r\n
deny	/di'nai/	v.否认,否定;拒绝\r\n
depart	/di'pɑ:t/	vi.离开,起程a.过去的,逝世的\r\n
department	/di'pɑ:tmənt/	n.部,局,处,科,部门;系,学部\r\n
departure	/di'pɑ:tʃə/	n.离开,起程\r\n
depend	/di'pend/	v.(on)取决于,依靠,信赖,相信\r\n
dependent	/di'pendənt/	a.依靠的,依赖的,从属的;随…而定的\r\n
depict	/di'pikt/	v.描绘;描写,描述\r\n
deposit	/di'pɔzit/	v.存放;使沉淀;付(保证金)n.存款;沉积物\r\n
depress	/di'pres/	v.压抑,降低;使沮丧,压下\r\n
deprive	/di'praiv/	vt.剥夺,夺去,使丧失\r\n
depth	/depθ/	n.深,深度,深奥,深刻\r\n
deputy	/'depjuti/	n.代理人,代表a.副的,代理的\r\n
derive	/di'raiv/	v.取得;导出;引申;来自;源自;出自\r\n
descend	/di'send/	v.下来,下降;遗传(指财产,气质,权利)\r\n
descendant	/di'sendənt/	n.子孙,后代\r\n
descent	/di'sent/	n.下降,降下;斜坡;血统,家世\r\n
describe	/di'skraib/	v.描述,形容\r\n
description	/di'skripʃən/	n.描写,形容;种类\r\n
desert	/'dezət/	n.沙漠,不毛之地v.抛弃,遗弃;擅离,开小差\r\n
deserve	/di'zə:v/	v.应受,值得\r\n
design	/di'zain/	v.设计;构思;绘制;图案;企图n.设计,图样\r\n
designate	/'deziɡneit/	v.指明,指出;任命,指派\r\n
desirable	/di'zaiərəbl/	a.值得做的;合意的,称心的;期望得到的\r\n
desire	/di'zaiə/	v./n.愿望,欲望,要求\r\n
desk	/desk/	n.书桌,办公桌,服务台\r\n
desolate	/'desələt,'desəleit/	a.荒凉的;孤独的v.使荒芜\r\n
despair	/di'spεə/	n.绝望;失望;令人失望的人(事物)v.绝望\r\n
despatch	/di'spætʃ/	n./v.(dispatch)派遣;发送n.急件;新闻报道\r\n
desperate	/'despərət/	a.不顾一切的,铤而走险的;绝望的,危急的\r\n
despise	/di'spaiz/	v.轻视,蔑视\r\n
despite	/di'spait/	prep.不管,不顾\r\n
dessert	/di'zə:t/	n.正餐后的水果或甜食\r\n
destination	/,desti'neiʃən/	n.目的地,终点\r\n
destiny	/'destini/	n.命运;天数,天命\r\n
destroy	/di'strɔi/	v.破坏,摧毁,消灭\r\n
destruction	/di'strʌkʃən/	n.毁坏,毁灭(的原因)\r\n
destructive	/di'strʌktiv/	a.破坏性\r\n
detach	/di'tætʃ/	vt.分开,分离,分遣,派遣(军队)\r\n
detail	/'di:teil,di'teil/	n.细节,详情v.详述\r\n
detain	/di'tein/	v.耽搁;扣押,拘留\r\n
detect	/di'tekt/	v.察觉,发觉,侦察,探测\r\n
detective	/di'tektiv/	n.侦探\r\n
detector	/di'tektə/	n.发现者,侦察器,探测器,检波器,检电器\r\n
deteriorate	/di'tiəriəreit/	v.(使)恶化,(使)变坏\r\n
determine	/di'tə:min/	v.决心,决定;确定,限定\r\n
develop	/di'veləp/	v.发展,开发,研制;显现,显影;发育,生长\r\n
deviate	/'di:vieit,'di:viət/	v.(from)背离,偏离\r\n
device	/di'vais/	n.装置,设备,仪表;方法,设计\r\n
devil	/'devəl/	n.魔鬼\r\n
devise	/di'vaiz/	vt.设计;发明;图谋;作出(计划);想出(办法)\r\n
devote	/di'vəut/	v.(to)奉献,致力\r\n
dew	/dju:,du:/	n.露水\r\n
diagnose	/'daiəɡnəuz/	vt.诊断(疾病);判断(问题)\r\n
diagram	/'daiəɡræm/	n.图表;图解\r\n
dial	/'daiəl,dail/	n.钟(表)面,刻度盘,拨号盘v.拨号,打电话\r\n
dialect	/'daiəlekt/	n.方言\r\n
dialog	/'daiəlɔɡ/	n.(dialogue)对话,对白\r\n
diameter	/dai'æmitə/	n.直径\r\n
diamond	/'daiəmənd/	n.金钢石,钻石;菱形\r\n
diary	/'daiəri/	n.日记,日记簿\r\n
dictate	/dik'teit,'dikteit/	v.口授;(使)听写;指令,指示,命令;\r\n
dictation	/dik'teiʃən/	n.听写,口述;命令\r\n
dictionary	/'dikʃənəri/	n.词典,字典\r\n
die	/dai/	vi.死,死亡;(草木)枯萎,凋谢;渴望\r\n
diet	/'daiət/	n.饮食,食物\r\n
differ	/'difə/	v.(from)与…不同;(with)与…意见不同\r\n
difference	/'difərəns/	n.差别,差异,分歧\r\n
different	/'difərənt/	a.差异的,差异的,不同的\r\n
differentiate	/,difə'renʃieit/	v.区分,区别;(使)不同\r\n
difficult	/'difikəlt/	a.困难的,艰难的\r\n
difficulty	/'difikəlti/	n.困难,困境,难题\r\n
diffuse	/di'fju:s/	v.扩散;传播a.(文章等)冗长的,漫无边际的\r\n
dig	/diɡ/	v.挖,掘\r\n
digest	/di'dʒest/	vt.消化;领会,融会贯通n.文摘,摘要\r\n
digital	/'didʒitəl/	a.数字的;数位的;手指的n.数字\r\n
dignity	/'diɡnəti/	n.(举止,态度等的)庄严,端庄;尊贵,高贵\r\n
dilemma	/di'lemə,,dai-/	n.(进退两难的)窘境,困境\r\n
diligent	/'dilidʒənt/	a.勤奋的,用功的\r\n
dilute	/dai'lju:t,di-/	vt.稀释,冲淡a.稀释的,冲淡的\r\n
dim	/dim/	a.暗淡的,模糊的\r\n
dimension	/di'menʃən,dai-/	n.尺寸,尺度;维(数),度(数)\r\n
diminish	/di'miniʃ/	v.缩小,减少,递减\r\n
dine	/dain/	v.吃饭,进餐\r\n
dinner	/'dinə/	n.正餐,宴会\r\n
dip	/dip/	v./n.浸,蘸\r\n
diploma	/di'pləumə/	n.毕业文凭,学位证书\r\n
diplomatic	/,diplə'mætik/	a.外交的,从事外交的;策略的,有手腕的\r\n
direct	/di'rekt,dai-/	a./ad.径直的(地)v.管理,指导;(at,to)指向\r\n
direction	/di'rekʃən,dai-/	n.方向,方位;指令,说明\r\n
directly	/di'rektli/	ad.直接地,径直地;马上,立即\r\n
director	/di'rektə/	n.指导者,主任,导演\r\n
directory	/di'rektəri,dai-/	n.人名地址录,(电话)号码簿\r\n
dirt	/də:t/	n.污物,污垢\r\n
dirty	/'də:ti/	a.弄脏的;下流的v.弄脏,玷污\r\n
disable	/dis'eib/	vt.使残废;使失去能力;丧失能力\r\n
disappear	/,disə'piə/	v.不见,消失\r\n
disappoint	/,disə'pɔint/	vt.失望;(希望等)破灭,挫败(计划等)\r\n
disaster	/,di'zɑ:stə/	n.灾难,大祸;彻底的失败\r\n
disastrous	/di'zɑ:strəs/	a.灾难性的\r\n
disc	/disk/	n.(disk)圆盘,圆面,盘状物\r\n
discard	/dis'kɑ:d,'diskɑ:d/	vt.丢弃,抛弃,遗弃\r\n
discern	/di'sə:n,-'zə:n/	v.认出,发现;辨别,识别\r\n
discharge	/dis'tʃɑ:dʒ/	v./n.卸货,排出;发射,放(电);遣散,解雇\r\n
discipline	/'disiplin/	n.纪律,学科\r\n
disclose	/dis'kləuz/	v.揭示,泄露\r\n
discount	/'diskaunt,dis'k-/	n.折扣;贴现(率)vt.打折扣;不重视\r\n
discourage	/dis'kʌridʒ/	v.使泄气,使失去信心\r\n
discourse	/'diskɔ:s,dis'kɔ:s/	n.论文;演说;谈话;话语vi.讲述,著述\r\n
discover	/dis'kʌvə/	v.发现,显示\r\n
discovery	/dis'kʌvəri/	n.发现;被发现的事物\r\n
discreet	/dis'kri:t/	a.(言行)谨慎的;慎重的;有判断力的\r\n
discrepancy	/dis'krepənsi/	n.相差;差异;矛盾;\r\n
discriminate	/dis'krimineit/	v.区别,辨别;(against)有差别地对待,歧视\r\n
discuss	/dis'kʌs/	vt.讨论,商议\r\n
disease	/di'zi:z/	n.疾病\r\n
disgrace	/dis'ɡreis/	n.失宠,耻辱v.使失宠;玷辱,使蒙羞\r\n
disguise	/dis'ɡaiz/	n./v.假装,伪装\r\n
disgust	/dis'ɡʌst/	n.厌恶,恶心v.使厌恶\r\n
dish	/diʃ/	n.碟子,盘子,菜肴\r\n
dislike	/dis'laik/	n./v.不喜欢,厌恶\r\n
dismay	/dis'mei/	n./v.(使)沮丧;(使)惊慌;(使)失望,(使)绝望\r\n
dismiss	/dis'mis/	v.免职,解雇,开除,解散\r\n
disorder	/dis'ɔ:də/	n.混乱,杂乱;骚乱;失调,疾病\r\n
disperse	/dis'pə:s/	v.(使)分散;(使)散开;疏散\r\n
displace	/dis'pleis/	v.移置,转移;取代,置换\r\n
display	/,dis'plei/	v./n.陈列,展览,显示(器)\r\n
disposal	/dis'pəuzəl/	n.处理,处置;布置,安排\r\n
dispose	/dis'pəuz/	v.(of)处理,处置;(for)布置,安排\r\n
disposition	/,dispə'ziʃən/	n.排列,部署;性格倾向;倾向,意向\r\n
dispute	/dis'pju:t,'dis-/	n.争论,争执v.争论,辩论;反驳;怀疑;阻止\r\n
disregard	/disri'ɡɑ:d/	vt.不理会;忽视;漠视n.忽视;漠视\r\n
disrupt	/dis'rʌpt/	vt.使混乱,使崩溃,使分裂,使瓦解\r\n
dissipate	/'disipeit/	v.驱散;(使云、雾、疑虑等)消散;挥霍\r\n
dissolve	/di'zɔlv/	v.(使)溶解,(使)融化;解散,取消\r\n
distance	/'distəns/	n.距离,间隔,远方,路程\r\n
distant	/'distənt/	a.远的;遥远的;疏远的;不亲近的\r\n
distill	/dis'til/	vt.蒸馏,用蒸馏法提取;吸取,提炼\r\n
distinct	/dis'tiŋkt/	a.清楚的,明显的;(from)截然不同的\r\n
distinction	/dis'tiŋkʃən/	n.区别,差别;级别;特性;声望;显赫\r\n
distinguish	/dis'tiŋɡwiʃ/	v.(from)区别,辨别;辨认出;使杰出\r\n
distort	/dis'tɔ:t/	v.弄歪(嘴脸等);扭曲;歪曲(真理、事实等)\r\n
distract	/dis'trækt/	v.分散;使分心;打扰;使心情烦乱\r\n
distress	/di'stres/	n.苦恼;危难;不幸v.使苦恼\r\n
distribute	/di'stribju:t,'dis-/	v.分发;分配;分布;配(电);(over)散布\r\n
district	/'distrikt/	n.地区,行政区;美国各州的众议院选区\r\n
disturb	/dis'tə:b/	v.扰乱,妨碍,使不安\r\n
disturbance	/di'stə:bəns/	n.动乱,骚乱,干扰\r\n
ditch	/ditʃ/	n.沟,沟渠,水沟\r\n
dive	/'di:vei,daiv/	v./n.潜水,跳水,俯冲\r\n
diverse	/dai'və:s,di-/	a.多种多样的,(from)不同的\r\n
diversion	/dai'və:ʃən,di-/	n.转向,转移;牵制;解闷;娱乐\r\n
divert	/dai'və:t,di-/	vt.使转向,使改道;转移(注意力);使娱乐\r\n
divide	/di'vaid/	v.分,划分,分开;分配;(by)除\r\n
dividend	/'dividend/	n.红利,股息;回报,效益;被除数\r\n
divine	/di'vain/	a.神的,神授的,天赐的;极好的,极美的\r\n
division	/di'viʒən/	n.分,分割;部门,科,处;除法;分界线\r\n
divorce	/di'vɔ:s/	v./n.离婚,分离\r\n
dizzy	/'dizi/	a.头晕目眩的,眩晕的;(可能)使人头晕的\r\n
do	/强du:,弱du,du:/	aux.v.vt.做,干,办,从事;引起vi.行动\r\n
dock	/dɒk/	n.船坞,码头\r\n
doctor	/dɔktə/	n.医生;博士vt.授以博士学位;诊断;修改\r\n
doctorate	/'dɔktərit/	n.博士学位;博士头衔\r\n
document	/'dɔkjumənt/	n.公文,文献\r\n
documentary	/,dɔkju'mentəri/	a.文献的n.记录片\r\n
dog	/dɔɡ,dɔ:ɡ/	n.狗,雄兽vt.尾随,跟踪\r\n
doll	/dɔl/	n.玩偶,玩具娃娃\r\n
dollar	/'dɔlə/	n.(美国,加拿大等国货币单位)美元,加元\r\n
domain	/dəu'mein/	n.(活动,思想等)领域,范围;领地\r\n
dome	/dəum/	n.圆屋顶\r\n
domestic	/dəu'mestik/	a.家里的;本国的;驯养的\r\n
dominant	/'dɔminənt/	a.支配的,统治的,占优势的\r\n
dominate	/'dɔmineit/	v.支配,统治,控制;占优势\r\n
donate	/dəu'neit,'dəu-/	vt.损赠(金钱等);赠予\r\n
donkey	/'dɔŋki/	n.驴子;蠢人;顽固的人\r\n
doom	/du:m/	n.厄运,劫数v.注定,命定\r\n
door	/dɔ:/	n.门;门口,出入口;门状物;家;通道\r\n
doorway	/'dɔ:wei/	n.门口\r\n
dorm	/dɔ:m/	n.(dormitory)［美］［口］宿舍\r\n
dose	/dəus/	n.剂量,一服,一剂v.(给…)服药\r\n
dot	/dɔt/	n.点,圆点v.在…上打点\r\n
doubt	/daut/	n./v.怀疑,疑虑\r\n
dove	/dʌv/	n.鸽子\r\n
down	/daun/	ad.下;由大到小prep.沿着…而下a.向下的\r\n
downstairs	/'daun'stεəz/	ad.在楼下,往楼下\r\n
downtown	/'daun'taun/	ad.在城市的商业区n./a.城市商业区(的)\r\n
downward	/'daunwəd/	a.向下的ad.(alsodownwards)向下,往下\r\n
doze	/dəuz/	v./n.瞌睡;假寐\r\n
dozen	/'dʌzən/	n.一打,十二个\r\n
draft	/drɑ:ft,dræft/	n.草稿,草案,草图v.起草,草拟\r\n
drag	/dræɡ/	v.拖,拖曳\r\n
dragon	/'dræɡən/	n.龙\r\n
drain	/drein/	n.排水沟,阴沟;消耗,负担v.排去,放干\r\n
drama	/'drɑ:mə,dræmə/	n.剧本,戏剧;戏剧性事件或场面\r\n
dramatic	/drə'mætik,-kəl/	a.戏剧的,戏剧性的;剧烈的\r\n
drastic	/'dræstik/	a.激烈的,严厉的;(药性等)猛烈的\r\n
draw	/drɔ:/	v.拉;画;汲取;引出;(to)挨近n.平局;拖曳\r\n
drawback	/'drɔ:bæk/	n.欠缺,缺点;退还的关税\r\n
drawer	/drɔ:/	n.抽屉\r\n
drawing	/'drɔ:iŋ/	n.绘图,图样\r\n
dread	/dred/	v./n.恐惧,担心\r\n
dream	/dri:m/	n./v.梦,梦想,幻想\r\n
dress	/dres/	n.服装,童装,女装v.穿衣,打扮\r\n
drift	/drift/	v./n.漂,漂流(物)\r\n
drill	/dril/	v.练习;操练;钻孔n.操练;练习;钻孔(机)\r\n
drink	/driŋk/	v.(drank,drunk)喝,饮n.饮料;喝酒\r\n
drip	/drip/	v.滴下,漏水n.滴,水滴,点滴\r\n
drive	/draiv/	v.开(车);驱;驱动,把(钉,桩)打入n.驾驶\r\n
driver	/draivə/	n.驾驶员\r\n
drop	/drɔp/	n.滴;落下;微量v.落下;下降;失落\r\n
drought	/draut/	n.旱灾,干旱\r\n
drown	/draun/	v.溺死,淹没\r\n
drug	/drʌɡ/	n.药物;麻醉品;毒品;滞销货v.下麻药;吸毒\r\n
drum	/drʌm/	n.鼓;圆桶\r\n
drunk	/drʌŋk/	a.醉酒的;(喻)陶醉的n.酗酒者,醉汉\r\n
dry	/drai/	a.干(旱)的;干渴的;枯燥vt.使干燥,晒干\r\n
dubious	/'dju:bjəs/	a.怀疑的,无把握的;有问题的,靠不住的\r\n
duck	/dʌk/	n.鸭,鸭肉v.迅速俯身;快速低头;躲避\r\n
due	/dju:,du:/	a.(to)应支付的;(车,船等)预定应到达的\r\n
dull	/dʌl/	a.单调的;迟钝的,愚笨的;不锋利的\r\n
dumb	/dʌm/	a.哑的,无言的\r\n
dump	/dʌmp/	v.倾倒,倾卸n.垃圾场\r\n
duplicate	/'dju:plikət/	n.复制品v.复写,使加倍a.复制的,二重的\r\n
durable	/'djuərəbl/	a.持久的,耐久的\r\n
duration	/djuə'reiʃən/	n.持久;期间;持续时间\r\n
during	/'djuəriŋ/	prep.在…期间\r\n
dusk	/dʌsk/	n.薄暮,黄昏\r\n
dust	/dʌst/	n.灰尘,尘土v.拂,掸\r\n
duty	/'dju:ti,'du:-/	n.义务,责任;职务;税\r\n
dwarf	/dwɔ:f/	n.矮子,侏儒,矮小的动植物vt.使…矮小\r\n
dwell	/dwel/	v.住,居留\r\n
dwelling	/'dweliŋ/	n.住宅,寓所\r\n
dye	/dai/	n.染料v.染,染色\r\n
dynamic	/dai'næmik/	a.动力的,电动的;有生气的\r\n
dynasty	/'dinəsti,'dai-/	n.王朝,朝代\r\n
each	/i:tʃ/	a./pron.各,各自的,每\r\n
eager	/'i:ɡə/	a.(for)渴望的,热切的\r\n
eagle	/'i:ɡl/	n.鹰\r\n
ear	/iə/	n.耳,耳朵;听力,听觉;穗\r\n
early	/'ə:li/	a.早的,早期的,及早的ad.早,在初期\r\n
earn	/ə:n/	v.赚得,挣得,获得\r\n
earnest	/'ə:nist/	a.热心的,诚挚的n.热心;真挚;定金;认真\r\n
earth	/ə:θ/	n.地球;陆地;泥土,土壤;尘世,人间\r\n
earthquake	/'ə:θkweik/	n.地震\r\n
ease	/i:z/	v.减轻;使舒适,使安心n.容易;舒适,悠闲\r\n
east	/i:st/	n.东,东方,东部a.东方的,东部的\r\n
Easter	/ˈiːstə(r)/	n.复活节\r\n
eastern	/'i:stən/	a.东方的,东部的\r\n
easy	/'i:zi/	a.容易的,不费力的,安逸的,宽裕的\r\n
eat	/i:t/	vt.吃,喝vi.吃饭,吃东西\r\n
ebb	/eb/	vi.衰退,减退n.处于低潮,处于衰退状态\r\n
eccentric	/ik'sentrik/	a.古怪的,怪癖的,异乎寻常的n.古怪的人\r\n
echo	/'ekəu/	v./n.回声,反响,共鸣\r\n
eclipse	/i'klips/	n.日食,月食\r\n
ecology	/i:'kɔlədʒi/	n.生态学\r\n
economic	/,i:kə'nɔmik/	a.经济(上)的,经济学的\r\n
economical	/,i:kə'nɔmikəl/	a.节约的,经济的\r\n
economics	/,i:kə'nɔmiks/	n.经济学,经济情况\r\n
economy	/i'kɔnəmi/	n.节约;经济\r\n
edge	/edʒ/	n.边,棱;刀口,刃v.侧身移动,挤进\r\n
edible	/'edibl/	a.可食用的\r\n
edit	/'edit/	v.编辑,校订\r\n
edition	/i'diʃən/	n.版,版本,版次\r\n
editor	/'editə/	n.编辑,编者\r\n
editorial	/,edi'tɔ:riəl/	n.社论a.社论的;编辑上的\r\n
educate	/'edju:keit/	v.教育,培养,训练\r\n
education	/,edju:'keiʃən/	n.教育,培养,训练\r\n
effect	/i'fekt/	n.结果;效果;影响;印象vt.招致;实现;达到\r\n
effective	/i'fektiv/	a.有效的,生效的;被实施的;给人深刻印象\r\n
efficiency	/i'fiʃənsi/	n.效率;功效\r\n
efficient	/i'fiʃənt/	a.有效的,效率高的;有能力的,能胜任的\r\n
effort	/'efət/	n.努力;成就;艰难的尝试\r\n
egg	/eɡ/	n.蛋;卵;卵形物\r\n
ego	/'i:ɡəu,'eɡəu/	n.自我,自负,利已主义;(心理学)自我意识\r\n
eight	/eit/	num.八pron.八(个,只...)\r\n
eighteen	/'ei'ti:n/	num.十八,十八个\r\n
eighty	/'eiti/	num./a.八十pron.八十(个,只...)\r\n
either	/'aiðə,'i:-/	ad.也(不)pron.两者之一a.(两者中)任一的\r\n
eject	/i'dʒekt,'i:dʒekt/	v.喷射,排出;驱逐\r\n
elaborate	/i'læbərət,i'læbəreit/	v./a.精心制作(的);详细阐述(的)\r\n
elapse	/i'læps/	vi．(时间)溜走;(光阴)逝去\r\n
elastic	/i'læstik/	a.弹性的n.松紧带,橡皮圈\r\n
elbow	/'elbəu/	n.肘,(衣服的)肘部vt.用肘推,用肘挤\r\n
elder	/'eldə/	a.年长的,资格老的n.长辈\r\n
elderly	/'eldəli/	a.较老的,年长的n./the～/到了晚年的人\r\n
elect	/ɪˈlekt/	v.选举,推选;选择,作出选择\r\n
electric	/i'lektrik/	a.电的,导电的,电动的\r\n
electrical	/i'lektrikəl/	a.电的,电学的\r\n
electrician	/,ilek'triʃən/	n.电学家,电工\r\n
electricity	/,ilek'trisəti/	n.电,电流;电学\r\n
electron	/i'lektrɔn/	n.电子\r\n
electronic	/,ilek'trɔnik/	a.电子的\r\n
elegant	/'eliɡənt/	a.优雅的;端庄的;雅致的\r\n
element	/'elimənt/	n.元素;要素;成分;元件;自然环境\r\n
elementary	/,eli'mentəri/	a.初步的;基本的;/化/元素的;自然力的\r\n
elephant	/'elifənt/	n.(动物)象\r\n
elevate	/'eliveit/	vt.举起,提拔,振奋,提升...的职位\r\n
elevator	/'eliveitə/	n.电梯,升降机\r\n
eleven	/i'levən/	num.十一pron./a.十一(个,只...)\r\n
eligible	/'elidʒəbl/	a.符合条件的;(尤指婚姻等)合适(意)的\r\n
eliminate	/i'limineit/	vt.除去;淘汰;排(删,消)除;削减(人员)\r\n
elite	/ei'li:t,i'li:t/	n.<法>/集合名词/精华;精锐;中坚分子\r\n
eloquent	/'eləkwənt/	a.雄辩的,有说服力的;善辩的,口才流利的\r\n
else	/els/	ad.其它,另外,别的;/与or连用/否则\r\n
elsewhere	/,els'hwεə/	ad.在别处,向别处\r\n
e-mail	/iː meɪl/	n.(electronicmail)电子信函,电子邮件\r\n
embark	/em'bɑ:k,im-/	v.(使)上船(或飞机,汽车等);着手,从事\r\n
embarrass	/im'bærəs/	vt.使困窘,使局促不安;阻碍,麻烦\r\n
embassy	/'embəsi/	n.大使馆;大使及其随员\r\n
embed	/im'bed/	vt.把…嵌(埋、插)入,扎牢;使深留脑中\r\n
embody	/im'bɔdi/	vt.具体表达,使具体化;包含,收录\r\n
embrace	/im'breis/	v.拥抱;包含;包围;环绕;采用;接受\r\n
emerge	/i'mə:dʒ/	vt.显现,浮现;暴露;形成;\r\n
emergency	/i'mə:dʒənsi/	n.紧急情况,突然事件,非常时刻\r\n
emigrate	/'emiɡreit/	v.(反)immigrate;(to,from)自本国移居他\r\n
eminent	/'eminənt/	a.显赫的;杰出的;有名的;优良的\r\n
emit	/i'mit/	vt.发出;放射;吐露;散发;发表;发行\r\n
emotion	/i'məuʃən/	n.情绪,情感,感情\r\n
emperor	/'empərə/	n.皇帝\r\n
emphasis	/'emfəsis/	n.强调,重点\r\n
emphasize	/'emfəsaiz/	v.(emphasise)强调\r\n
empire	/'empaiə/	n.帝国\r\n
empirical	/em'pirikəl/	a.凭经验(或观察)的,经验主义的\r\n
employ	/im'plɔi/	n./v.雇用;用,使用\r\n
employee	/,emplɔi'i:,em'plɔii:/	n.雇工,雇员\r\n
employer	/im'plɔiə/	n.雇主\r\n
employment	/im'plɔimənt/	n.雇用;使用;工作,职业\r\n
empty	/'empti/	a.空的;空洞的v.倒空,使成为空的\r\n
enable	/i'neibl/	v.使能够,使成为可能;授予权利或方法\r\n
enclose	/in'kləuz/	v.围住,圈起,封入\r\n
enclosure	/in'kləuʒə/	n.围住,圈起,封入,附件\r\n
encounter	/in'kauntə/	n./v.遇到,遭遇\r\n
encourage	/in'kʌridʒ/	v.鼓励,怂恿\r\n
encyclopedia	/en,saikləu'pi:djə/	n.(encyclopaedia)百科全书\r\n
end	/end/	n.末端,端,梢;目标,目的v.终止,结束\r\n
endeavor	/in'devə/	v./n.(endeavour)努力,尽力,力图\r\n
ending	/'endiŋ/	n.结尾,结局\r\n
endow	/in'dau/	vt.资助,捐赠;(with)给予,赋予\r\n
endurance	/in'djuərəns/	n.忍耐(力),持久(力),耐久(性)\r\n
endure	/in'djuə/	v.忍受,持久,持续\r\n
enemy	/'enimi/	n.敌人,仇敌,反对者;敌人,敌军,敌国\r\n
energetic	/,enə'dʒetik/	a.精力旺盛的;积极的;有力的\r\n
energy	/'enədʒi/	n.活力,精力;能,能量\r\n
enforce	/in'fɔ:s/	v.实施,执行;强制;支持,坚持(要求,主张等)\r\n
engage	/in'ɡeidʒ/	v.(in)从事,着手;约定;使订婚;保证;雇用\r\n
engagement	/in'ɡeidʒmənt/	n.约会,约定;婚约,订婚\r\n
engine	/'endʒin/	n.发动机,引擎;火车头\r\n
engineer	/,endʒi'niə/	n.工程师\r\n
engineering	/,endʒi'niəriŋ/	n.工程学\r\n
enhance	/in'hɑ:ns,-hæns/	v.提高,增强\r\n
enjoy	/in'dʒɔi/	vt.享受…的乐趣;欣赏;喜爱\r\n
enlarge	/in'lɑ:dʒ/	vt.扩大,放大,增大\r\n
enlighten	/in'laitən/	v.启发,启蒙,教导\r\n
enormous	/i'nɔ:məs/	a.巨大的,庞大的\r\n
enough	/i'nʌf/	a.(for)足够的n.足够,充分ad.足够地\r\n
enquire	/in'kwaiə/	v.(inquire)询问,打听;调查;查问\r\n
enrich	/in'ritʃ/	v.使富足;使肥沃;装饰;加料于;浓缩\r\n
enroll	/in'rəul/	v.(enrol)招收;登记;入学;参军;成为会员\r\n
ensure	/in'ʃuə/	v.确保,保证;使安全\r\n
entail	/in'teil/	vt.使承担;需要;把(疾病等)遗传给;限定\r\n
enter	/'entə/	vt.进入;参加,加入;写入vi.进去,进来\r\n
enterprise	/'entəpraiz/	n.事业,企(事)业单位;事业心,进取心\r\n
entertain	/,entə'tein/	v.招待,款待;使娱乐;使欢乐;容纳,接受\r\n
entertainment	/,entə'teinmənt/	n.招待,款待;表演文娱节目\r\n
enthusiasm	/in'θju:ziæzəm/	n.热情,热心;狂热;积极性(for)\r\n
enthusiastic	/in,θju:zi'æstik/	a.热情的,热心的\r\n
entire	/in'taiə/	a.完全的,全部的,完整的\r\n
entitle	/in'taitl/	v.给以权利(或资格);给…称号(题名);授权\r\n
entity	/'entəti/	n.实体;存在(物);组织,机构;本质\r\n
entrance	/'entrəns/	n.入口,门口;进入;入学,入会\r\n
entrepreneur	/,ɔntrəprə'nə:/	n./法/企业家,主办人\r\n
entry	/'entri/	n.进入,入口;通道;记载,条目\r\n
envelope	/'envələup/	n.信封,信皮;封套\r\n
environment	/in'vaiərənmənt/	n.环境,外界\r\n
envisage	/in'vizidʒ/	v.想象,设想,展望,正视\r\n
envy	/'envi/	v./n.羡慕,忌妒\r\n
epidemic	/,epi'demik/	a.流行性的;传染的n.流行病;传播\r\n
episode	/'episəud/	n.一段情节;片断;(连续剧的)一集\r\n
epoch	/'i:pɔk,'epək/	n.新纪元;时代;时期;【地质】世,纪,期\r\n
equal	/'i:kwəl/	a.相等的;胜任的n.相等的事务;对手v.等于\r\n
equality	/i:'kwɔləti/	n.同等;平等;相等;等式;等同性\r\n
equation	/i'kweiʒən,-ʃən/	n.(数学)等式,方程式;(with)相等;均衡\r\n
equator	/i'kweitə/	n.赤道\r\n
equip	/i'kwip/	v.(with)装备,配备;训练\r\n
equipment	/i'kwipmənt/	n.设备,器材,装置;才能\r\n
equivalent	/i'kwivələnt/	a.(to)相等的,等价的n.相等物,等价物\r\n
era	/'iərə,'εərə/	n.时代,年代,阶段,纪元\r\n
erase	/i'reiz,i'reis/	v.擦掉;删去;消磁\r\n
erect	/i'rekt/	v.树立,建立,使竖立a.直立的,垂直的\r\n
erosion	/i'rəuʒən/	n.腐蚀,磨损;削弱,减少\r\n
erroneous	/i'rəuniəs/	a.错误的,不正确的\r\n
error	/'erə/	n.错误,过失\r\n
erupt	/i'rʌpt/	v.(尤指火山)爆发\r\n
escalate	/'eskəleit/	v.(使)逐步增长(或发展),(使)逐步升级\r\n
escape	/i'skeip/	n.逃跑,逃脱v.逃跑;避开,避免\r\n
escort	/'eskɔ:t,i'skɔ:t/	vt.护送(卫);陪同n.警卫,护送者;仪仗兵\r\n
especially	/i'speʃəli/	ad.特别,尤其,格外;专门地,主要地\r\n
essay	/'esei,e'sei/	n.文章,短文\r\n
essence	/'esəns/	n.本质,实质\r\n
essential	/i'senʃəl/	a.本质的,基本的;净化的n.本质;要素\r\n
establish	/i'stæbliʃ/	v.建立,设立;安置,使定居\r\n
establishment	/i'stæbliʃmənt/	n.建立,设立,建立的机构(或组织)\r\n
estate	/i'steit/	n.房地产;不动产;所有权;地位;生活状况\r\n
esteem	/i'sti:m/	n.尊敬,尊重vt.尊重,敬重;把…看作\r\n
estimate	/'estimeit/	v./n.估计,估价;评估\r\n
eternal	/i'tə:nəl/	n.永久的,永恒的\r\n
ethnic	/'eθnik/	a.种族的;人种学的\r\n
evacuate	/i'vækjueit/	vt.撤离,疏散,排泄,剥夺\r\n
evade	/i'veid/	vt.逃避,回避;避开,躲避\r\n
evaluate	/i'væljueit/	v.估价,评价;求…的值\r\n
evaporate	/i'væpəreit/	v.蒸发,挥发;沉淀;发射;消失\r\n
eve	/i:v/	n.(节日等的)前夜,前夕\r\n
even	/'i:vən/	ad.甚至(更)a.均匀的;平的;相等的;偶数的\r\n
evening	/'i:vniŋ/	n.傍晚,黄昏,晚上\r\n
event	/i'vent/	n.事件,事情\r\n
eventually	/i'ventʃuəli/	ad.终于,最后\r\n
ever	/'evə/	ad.曾经;永远;在任何时候;究竟\r\n
every	/'evri/	a.每一个的,每个的;每隔…的;全部的\r\n
everybody	/'evri,bədi/	pron.(everyone)每人,人人\r\n
everyday	/'evridei/	adj.每日的,日常的\r\n
everyone	/'evriwʌn/	pron.(everybody)每人,人人,各人\r\n
everything	/'evriθiŋ/	pron.每件事,一切;最重要的东西\r\n
everywhere	/'evrihwεə/	ad.到处,各处,无论何处\r\n
evidence	/'evidəns/	n.明显;显著;根据;证据;迹象\r\n
evident	/'evidənt/	a.明显的,明白的\r\n
evil	/'i:vəl/	a.邪恶的,罪恶的n.邪恶,罪恶\r\n
evoke	/i'vəuk/	vt.唤起(回忆、感情等);引起\r\n
evolution	/,i:və'lu:ʃən,,ev-/	n.进化,演变,发展,进展\r\n
evolve	/i'vɔlv/	v.(使)发展;(使)进化;(使)进展\r\n
exact	/iɡ'zækt/	a.确切的,正确的,精确的\r\n
exaggerate	/iɡ'zædʒəreit/	v.夸大,夸张\r\n
exam	/iɡ'zæm/	n.(examination)考试,测验\r\n
examine	/iɡ'zæmin/	v.检查,调查;对…进行考试\r\n
example	/iɡ'zɑ:mpl/	n.例子,实例;模范,榜样\r\n
exceed	/ik'si:d/	v.超过,胜过;越出\r\n
exceedingly	/ik'si:diŋli/	ad.极端地,非常\r\n
excel	/ik'sel/	vi.胜过其他;擅长vt.胜过,优于\r\n
excellent	/'eksələnt/	a.卓越的,极好的\r\n
except	/ik'sept/	prep.除…之外v.除外;反对\r\n
exception	/ik'sepʃən/	n.例外,除外;反对;异议\r\n
exceptional	/ik'sepʃənəl/	a.例外的,异常的\r\n
excerpt	/ek'sə:pt,'eksə:pt/	n./vt.摘录;引用\r\n
excess	/ik'ses/	a.过量的,额外的n.过量;过剩;超额;无节制\r\n
excessive	/ik'sesiv/	a.过多的;过分的;额外\r\n
exchange	/iks'tʃeindʒ/	v./n.(for)交换,兑换;交流,交易;交换台\r\n
excite	/ik'sait/	v.刺激,使激动;激发,激励\r\n
excitement	/ik'saitmənt/	n.刺激,激动,兴奋\r\n
exciting	/ik'saitiŋ/	a.令人兴奋的,使人激动的\r\n
exclaim	/ik'skleim/	v.呼喊,惊叫,大声说\r\n
exclude	/iks'klu:d/	v.拒绝,把…排除在外,排斥\r\n
exclusive	/ik'sklu:siv/	a.独占的;排他的;孤高的;唯一的;高级的\r\n
excursion	/ik'skə:ʃən/	n.短途旅行,游览;离题;/物理/偏移,漂移\r\n
excuse	/ik'skju:z,ik'skju:s/	v.原谅,宽恕,免除n.借口,辩解\r\n
execute	/'eksikju:t/	v.实行;实施;执行;完成;履行;处死\r\n
executive	/iɡ'zekjutiv/	n.总经理,董事,行政负责人a.执行的,实施的\r\n
exemplify	/iɡ'zemplifai/	v.举例证明;示范;作...的范例/榜样/\r\n
exempt	/iɡ'zempt/	a.免除的v.免除n.免税者;被免除义务者\r\n
exercise	/'eksəsaiz/	n.练习,习题;训练,锻练v.训练,锻练;行使\r\n
exert	/iɡ'zə:t/	v.尽(力),施加(压力等),努力\r\n
exhaust	/iɡ'zɔ:st/	v.使筋疲力尽,耗尽;抽完n.排气装置;废气\r\n
exhibit	/iɡ'zibit/	v.展出,陈列n.展览品,陈列品\r\n
exhibition	/,eksi'biʃən/	n.展览会;陈列,展览\r\n
exile	/'eɡzail,'eksail/	n.流放;被流放者vt.流放,放逐,把…充军\r\n
exist	/iɡ'zist/	v.存在;生存;生活\r\n
existence	/iɡ'zistəns/	n.存在,实在;生存,生活(方式)\r\n
exit	/'eksit,'eɡzit/	n.出口,通道\r\n
exotic	/,iɡ'zɔtik/	a.奇异的;异国情调的;外(国)来的\r\n
expand	/ik'spænd/	v.(使)膨胀,(使)扩张;张开,展开\r\n
expansion	/ik'spænʃən/	n.扩张,膨胀;张开,伸展\r\n
expect	/ik'spekt/	v.预期;期望,指望\r\n
expectation	/,ekspek'teiʃən/	n.预期,期望,指望\r\n
expedition	/,ekspi'diʃən/	n.远征(队),探险(队)\r\n
expel	/ik'spel/	v.把…开除;驱逐;排出;发射\r\n
expend	/ik'spend/	v.消费,花费\r\n
expenditure	/iks'penditʃə/	n.花费;(时间,金钱等的)支出,消耗\r\n
expense	/ik'spens/	n.花费,消费,消耗\r\n
expensive	/ik'spensiv/	a.花费的,昂贵的\r\n
experience	/ik'spiəriəns/	n./vt.经验;经历;体验;阅历\r\n
experiment	/ik'speriment,ek's-/	n.实验;试验v.(on)进行实验;做试验\r\n
experimental	/ek,speri'mentəl,ek's-/	a.实验(性)的,试验(性)的\r\n
expert	/'ekspə:t,ek'spə:t/	n.专家,能手a.熟练的,有经验的;专门的\r\n
expertise	/,ekspə:'ti:z/	n.专门知识(或技能等),专长\r\n
expire	/ik'spaiə,ek-/	v.期满,(期限)终止;呼气;断气,死亡\r\n
explain	/ik'splein/	v.解释,说明\r\n
explanation	/,eksplə'neiʃən/	n.解释,说明\r\n
explicit	/ik'splisit/	a.详述的,明确的;坦率的;显然的\r\n
explode	/ik'spləud/	v.(使)爆炸,(使)爆发\r\n
exploit	/'eksplɔit,ik's-/	v.开拓;开发;剥削n.功绩/勋/;业绩\r\n
explore	/ik'splɔ:/	v.勘探,探测;探究,探索\r\n
explosion	/ik'spləuʒən/	n.爆炸,爆发\r\n
explosive	/ik'spləusiv/	a.爆炸(性)的,爆发(性)的n.爆炸物,炸药\r\n
export	/ik'spɔ:t,'ekspɔ:t/	v./n.输出,出口n.出口商品\r\n
expose	/ik'spəuz/	v.(to)使暴露,受到;使曝光\r\n
exposure	/ik'spəuʒə/	n.暴露,揭露;方向;陈列;遗弃;照射量\r\n
express	/ik'spres/	v.表达,表示a.特快的,快速的n.快车,快运\r\n
expression	/ik'spreʃən/	n.表达;表情;声调;腔调;榨出;措词;式;符号\r\n
exquisite	/'ekskwizit/	a.优美的,高雅的,精致的;剧烈的,异常的\r\n
extend	/ik'stend/	v.延长,延伸;扩充;给予;提供;估价\r\n
extension	/ik'stenʃən/	n.延长;扩大;范围;大小;尺寸;电话分机\r\n
extensive	/ik'stensiv/	a.广大的,广阔的\r\n
extent	/ik'stent/	n.广度,宽度,长度;程度,限度\r\n
exterior	/ik'stiəriə/	a.外部的,外面的n.外部\r\n
external	/ik'stə:nəl/	a.外部的;客观的;外国的;表面的;/医/外用的\r\n
extinct	/ik'stiŋkt/	a.灭绝的;熄灭了的\r\n
extinguish	/ik'stiŋɡwiʃ/	v.熄灭;消灭;结束;压制;使黯然失色;偿清\r\n
extra	/'ekstrə/	a.额外的,附加的n.附加物,额外的东西\r\n
extract	/ik'strækt,'ekstrækt/	v./n.拔出,抽出;摘录n.抽取物;精华;选集\r\n
extraordinary	/ik'strɔ:dənəri/	a.非常的;格外的;意外的;离奇的;临时的\r\n
extravagant	/ik'strævəɡənt/	a.奢侈的;过分的;(言行等)放肆的\r\n
extreme	/ik'stri:m/	a.末端的,尽头的;极度的n.极端;最大程度\r\n
eye	/ai/	n.眼(睛);视力;眼力;监督vt.看,审视\r\n
eyebrow	/'aibrau/	n.眉毛\r\n
eyesight	/'aisait/	n.视力\r\n
fable	/'feibl/	n.寓言\r\n
fabric	/'fæbrik/	n.织物;织品;结构;构造;建筑物\r\n
fabricate	/'fæbrikeit/	v.捏造,编造(谎言,借口等);建造,制造\r\n
fabulous	/'fæbjuləs/	a.极好的;极为巨大的;寓言中的,传说中的\r\n
face	/feis/	n.脸,面貌;表情;正面v.面对着;朝,面向\r\n
facilitate	/fə'siliteit/	v.使变得(更)容易;使便利;推动;帮助;处进\r\n
facility	/fə'siliti/	n.灵巧,熟练;(pl.)设备,设施,便利条件\r\n
fact	/fækt/	n.事实,实际\r\n
factor	/'fæktə/	n.因素,要素\r\n
factory	/'fæktəri/	n.工厂\r\n
faculty	/'fækəlti/	n.才能;学院,系;(学院或系的)全体教学人员\r\n
fade	/feid,fad/	v.褪色;衰减,消失n.淡入(出)n.乏味(平淡)的\r\n
fail	/feil/	v.失败,不及格;衰退,减弱\r\n
failure	/'feiljə/	n.失败,不及格;失败者;故障,失灵;未能\r\n
faint	/'feint/	a.微弱的;不明显的;暗淡的n./v.昏倒;昏晕\r\n
fair	/fεə/	a.公平的,合理的;相当的n.集市,交易会\r\n
fairly	/'fεəli/	ad.公正地,正当地;相当,还算\r\n
fairy	/'fεəri/	a.幻想中的;虚构的;优雅的n.仙女;精灵\r\n
faith	/feiθ/	n.信任,信用;信仰,信条\r\n
faithful	/'feiθful/	a.守信的,忠实的,如实的,可靠的\r\n
fake	/feik/	n.假货,赝品a.假的,冒充的v.伪造;伪装\r\n
fall	/fɔ:l/	v.跌倒;下降;减弱;坠落;变成,陷于n.秋季\r\n
FALSE	/fɔ:ls/	a.谬误的,虚伪的,伪造的,假的\r\n
fame	/feim/	n.名声;名望;传说vt使出名;传扬…的名\r\n
familiar	/fə'miljə/	a.熟悉的;通晓的;亲近的n.熟客;密友\r\n
family	/'fæmili/	n.家,家庭成员;氏族,家庭;族,科\r\n
famine	/'fæmin/	n.饥荒,饥馑\r\n
famous	/'feiməs/	a.著名的\r\n
fan	/fæn/	n.扇子,风扇;(影,球等)迷v.扇,扇动,激起\r\n
fancy	/'fænsi/	n.爱好,迷恋v.想象,幻想a.花式的,奇特的\r\n
fantastic	/fæn'tæstik/	a.(fantastical)奇异的,幻想的,异想天开的\r\n
fantasy	/'fæntəsi/	n.幻想,空想;空想的产物,幻想作品\r\n
far	/fɑ:/	a./ad.远,久远,遥远ad.到…程度,…得多\r\n
fare	/fεə/	n.车费,船费;伙食;乘客v.过活;进展;经营\r\n
farewell	/'fεə'wel/	int.再会,别了n.告别\r\n
farm	/fɑ:m/	n.农场,饲养场v.种田,经营农牧业\r\n
farmer	/'fɑ:mə/	n.农民,农场主\r\n
farther	/'fɑ:ðə/	ad.更远地,再往前地a.更远的\r\n
fascinate	/'fæsineit/	v.迷住,强烈吸引\r\n
fashion	/'fæʃən/	n.流行式样(或货品),风尚,风气;样子,方式\r\n
fashionable	/'fæʃənəbl/	a.流行的,时髦的\r\n
fast	/fɑ:st,fæst/	a.快的,迅速的;坚固的ad.紧紧地;迅速地\r\n
fasten	/'fɑ:sən,'fæ-/	v.扎牢,使固定\r\n
fat	/fæt/	a.多脂肪的,肥胖的;丰厚的n.脂肪,肥肉\r\n
fatal	/'feitl/	a.致命的,毁灭性的\r\n
fate	/'feit/	n.命运\r\n
father	/'fɑ:ðə/	n.父亲;创始人,发明者;(Father)神父\r\n
fatigue	/fə'ti:ɡ/	n./v.(使)疲劳\r\n
fault	/fɔ:lt/	n.过失,过错;缺点,毛病\r\n
faulty	/'fɔ:lti/	a.有错误的,有缺点的,不完善的\r\n
favor	/'feivə/	n.(favour)好感;喜爱;关切v.赞成,支持,偏爱\r\n
favorable	/'feivərəbl/	a.(favourable)赞许的,有利的,讨人喜欢的\r\n
favorite	/'feivərit/	n.(favourite)最喜欢的人或物a.喜爱的\r\n
fax	/fæks/	n./v.传真(机)\r\n
fear	/fiə/	n.害怕,恐惧;危险vt.畏惧,害怕,担心\r\n
fearful	/'fiəful/	a.可怕的,吓人的;害怕,担心,惊恐\r\n
feasible	/'fi:zəbl/	a.可行的;切实可行的;行得通的;可用的\r\n
feast	/fi:st/	n.节日;宴会\r\n
feat	/fi:t/	n.功绩,伟业,技艺\r\n
feather	/'feðə/	n.羽毛\r\n
feature	/'fi:tʃə/	n.特征;容貌;特色;特写v.以...为特色\r\n
February	/ˈfebruəri/	n.二月\r\n
federal	/'fedərəl/	a.联邦的;联邦制的;联合的;同盟的\r\n
federation	/'fedəreiʃən/	n.同盟;联邦;联合;联盟;联合会\r\n
fee	/fi:/	n.费(会费,学费等);酬金\r\n
feeble	/'fi:bl/	a.虚弱的,无力的\r\n
feed	/fi:d/	v.(on,with)喂养,饲养;(with)向…供给\r\n
feedback	/'fi:dbæk/	n.反馈;反应;回授\r\n
feel	/'fi:l/	v.触;认为vi.摸上去有…感觉;摸索;觉得\r\n
feeling	/'fi:liŋ/	n.感情;心情;知觉;同情\r\n
fell	/fel/	v.击倒fel;打倒(疾病等);砍伐a.凶猛的;可怕的\r\n
fellow	/'feləu/	n.人,家伙;伙伴,同事a.同样的,同事的\r\n
fellowship	/'feləuʃip/	n.伙伴关系;联谊会,团体\r\n
female	/'fi:meil/	n.女性;女人;雌兽a.女性的;雌的;柔弱的\r\n
feminine	/'feminin/	a.女性的;娇柔的\r\n
fence	/'fens/	n.篱笆;围栏;剑术v.用篱笆瓦围住;击剑\r\n
ferry	/'feri/	n.摆渡;渡船;渡口v.摆渡;渡运(人,车或物等)\r\n
fertile	/'fə:tail/	a.肥沃的,富饶的;能繁殖的\r\n
fertilizer	/'fə:tilaizə/	n.(fertiliser)肥料\r\n
festival	/'festəvəl/	n.节日;音乐节;戏剧节a.节日的;快乐的\r\n
fetch	/fetʃ/	v.取来;接来;引出;售得;吸引n.取得;拿\r\n
feudal	/'fju:dl/	a.封建的;封地的;领地的\r\n
fever	/'fi:və/	n.发热,狂热\r\n
few	/fju:/	a./表肯定/有些,几个;/表否定/几乎没有的\r\n
fiber	/'faibə/	n.(fibre)纤维;构造;纤维制品\r\n
fiction	/'fikʃən/	n.虚构,编造;小说\r\n
field	/'fi:ld/	n.田野;运动场;(电或磁)场;领域,范围\r\n
fierce	/fiəs/	a.凶猛的,残忍的;狂热的,强烈的\r\n
fifteen	/'fifti:n/	num.十五pron./a.十五(个,只...)\r\n
fifty	/'fifti/	num.五十,五十个\r\n
fight	/fait/	v./n.打(仗),搏斗,斗争,战斗\r\n
figure	/'fiɡə/	n.体形;轮廓;数字;图形v.描绘;计算;推测\r\n
file	/'fail/	n.锉刀;文件,档案v.锉\r\n
fill	/fil/	v.(with)填满,充满\r\n
film	/film/	n.电影;胶片;薄膜,薄层vt.把..拍成电影\r\n
filter	/filtə/	n.滤器,滤纸\r\n
final	/'fainl/	a.最终的,决定性的n.结局;决赛;期末考试\r\n
finally	/'fainəli/	ad.最后,最终;决定性地\r\n
finance	/fai'næns/	n.财政,金融v.为…提供资金\r\n
financial	/fai'nænʃəl/	a.财政的,金融的\r\n
find	/faind/	v.(found,found)找到;发现;发觉;感到\r\n
finding	/'faindiŋ/	n.发现,发现物;(常pl.)调查/研究结果\r\n
fine	/fain/	a.晴朗的,美好的,细致的v./n.罚金,罚款\r\n
finger	/'fiŋɡə/	n.手指;指状物;指针\r\n
finish	/'finiʃ/	n.完成;结束;磨光v.完成;结束;用完;毁掉\r\n
finite	/'fainait/	a.有限的;/数/有穷的,限定的\r\n
fire	/'faiə/	n.火;火灾,失火;炉火vi.开火vt.放(枪)\r\n
fireman	/'faiəmən/	n.消防队员\r\n
fireplace	/'faiəpleis/	n.壁炉\r\n
firm	/'fə:m/	a.坚固的;坚决的,坚定的n.公司,商号\r\n
first	/fə:st/	a./ad.第一;最初;首次n.开始pron.第一名\r\n
fish	/fiʃ/	n.(pl.fish(es))鱼;鱼肉v.捕鱼;钓鱼\r\n
fisherman	/'fiʃəmən/	n.渔夫,捕鱼人\r\n
fist	/fist/	n.拳头vt.用拳头打;紧握\r\n
fit	/'fit/	a.(病的)发作,痉挛v./a.n.合适,试穿,安装\r\n
fitting	/'fitiŋ/	a.适当的,恰当的n.(常pl.)配件,附件;装配\r\n
five	/faiv/	num.五pron./a.五(个,只...)\r\n
fix	/fiks/	v.(使)固定;修理;安装;决定;注视n.困境\r\n
fixture	/'fikstʃə/	n.固定设备;预定日期;比赛时间;定期存款\r\n
flag	/flæɡ/	n.旗\r\n
flame	/fleim/	n.火焰,火苗;热情;光辉v.发火焰,燃烧\r\n
flap	/flæp/	n.垂下物,帽沿,袋盖n./v.拍打,拍动\r\n
flare	/flεə/	v./n.闪耀,闪烁\r\n
flash	/flæʃ/	n./a.闪光(的)v.发闪光,闪亮;闪现\r\n
flat	/flæt/	a.平坦的,扁平的,平淡的n.一套房间;平面\r\n
flatter	/'fleivə/	vt.奉承;使高兴;使满意;胜过\r\n
flavor	/'fleivə/	n.(flavour)情味;风味;滋味v.给…调味\r\n
flaw	/flɔ:/	n.裂缝;缺陷v.使破裂;使有缺陷\r\n
flee	/fli:/	v.逃走;逃避\r\n
fleet	/fli:t/	n.舰队,船队\r\n
flesh	/fleʃ/	n.肉,肌肉\r\n
flexible	/'fleksibl/	a.柔韧的,易弯曲的,灵活的,能变形的\r\n
flight	/flait/	n.飞翔,飞行;航班;航程;逃跑;楼梯的一段\r\n
fling	/fliŋ/	v.(用力地)扔,抛,丢\r\n
float	/fləut/	n.飘浮;漂流物v.浮动;漂浮;传播;动摇\r\n
flock	/flɔk/	n.(一)群,(禽,畜等的)群;大量v.群集,成群\r\n
flood	/flʌd/	n.洪水,水灾v.淹没,发大水,泛滥\r\n
floor	/flɔ:/	n.地板,(楼房)的层\r\n
flour	/'flauə/	n.面粉\r\n
flourish	/'flauriʃ/	n./v.繁荣,茂盛,兴旺\r\n
flow	/fləu/	v.流,流动n.流量,流速\r\n
flower	/'flauə/	n.花;精华,精粹,精英;盛时vi.开花\r\n
flu	/flu:/	n.(influenza)流行性感冒\r\n
fluctuate	/'flʌktjueit/	v.(使)波动;(使)起伏\r\n
fluent	/'flu(:)ənt/	a.流利的,流畅的\r\n
fluid	/'flu(:)id/	a.流动的,液体的n.流体,液体\r\n
flush	/flʌʃ/	n.脸红v.发红;奔流a.洋溢的;富裕的;齐平的\r\n
fly	/flai/	n.飞行;苍蝇v飞行;飘杨a.机敏的\r\n
foam	/fəum/	v./n.泡沫,起泡沫\r\n
focus	/'fəukəs/	n.焦点,(活动,兴趣等的)中心v.(on)使聚集\r\n
fog	/fɔɡ/	n.雾气,雾v.以雾笼罩,被雾笼罩\r\n
fold	/fəuld/	v.折叠;合拢;抱住n.褶,褶痕;羊栏;信徒\r\n
folk	/fəuk/	n.人们;民族;亲属a.民间的\r\n
follow	/'fɔləu/	v.跟随,接着;领会;沿着…前进,遵循;结果是\r\n
following	/'fɔləuiŋ/	a.下列的,下述的,其次的,接着的\r\n
fond	/fɔnd/	a.(of)喜爱的,爱好的\r\n
food	/fu:d/	n.食物,粮食,养料\r\n
fool	/fu:l/	n.傻子,笨蛋vt.欺骗,愚弄vi.干蠢事\r\n
foolish	/'fu:liʃ/	a.愚笨的,愚蠢的\r\n
foot	/fut/	n.(pl.feet)脚,足;英尺;底部\r\n
football	/'fut,bɔ:l/	n.足球\r\n
footstep	/'fut'step/	n.脚步(声),足迹\r\n
for	/强fɔ:,弱fə/	prep.为了;给;代替;向;支持conj.因为?\r\n
forbid	/fə'bid/	v.禁止,不许\r\n
force	/fɔ:s/	n.力量,力;势力;(pl.)(总称)军队v.强迫\r\n
fore	/fɔ:/	ad.在前面a.先前的;在前部的n.前部\r\n
forecast	/'fɔ:kɑ:st/	v./n.预测,预报\r\n
forehead	/'fɔrid/	n.前额;(任何事物的)前部\r\n
foreign	/'fɔrin/	a.外国的,(to)无关的;外来的;异质的\r\n
foreigner	/'fɔrinə/	n.外国人\r\n
foremost	/'fɔ:məust/	a.最先的;最初的;主要的ad.首要地\r\n
foresee	/fɔ:'si:/	v.预见,预知\r\n
forest	/'fɔrist/	n.森林\r\n
forever	/fə'revə/	adv.(forever)永远;总是\r\n
forge	/fɔ:dʒ/	v.锻造,伪造n.锻工车间;锻炉\r\n
forget	/fə'ɡet/	v.忘记,遗忘\r\n
forgive	/fə'ɡiv/	v.原谅,饶恕\r\n
fork	/fɔ:k/	n.叉,耙;叉形物;餐叉\r\n
form	/fɔ:m/	n.形状,形式;表格v.组成,构成;形成\r\n
formal	/'fɔ:məl/	a.正式的;形式的\r\n
format	/'fɔ:mæt/	n.(出版物的)开本,版式,格式vt.设计;安排\r\n
formation	/'fɔ:mə/	n.形成;构成;组织;构造;编制;塑造\r\n
former	/'fɔ:mə/	a.以前的,在前的pron.前者\r\n
formidable	/'fɔ:midəbl/	a.强大的;令人敬畏的;可怕的;艰难的\r\n
formula	/'fɔ:mjulə/	n.(pl.formulae)公式;规则;分子式;药方\r\n
formulate	/'fɔ:mjuleit/	v.用公式表示;规划;设计;系统地阐述\r\n
forth	/fɔ:θ/	ad.向前;向外,往外\r\n
forthcoming	/'fɔ:θ'kʌmiŋ/	a.即将到来的;准备好的;乐意帮助的;n.来临\r\n
fortnight	/'fɔ:tnait/	n.两星期\r\n
fortunate	/'fɔ:tʃənit/	a.幸运的,侥幸的\r\n
fortune	/'fɔ:tʃən,-tʃu:n/	n.运气;命运;财产;财富\r\n
forty	/'fɔ:ti/	num./a.四十pron.四十(个,只...)\r\n
forum	/'fɔ:rəm/	n.论坛,讨论会\r\n
forward	/'fɔ:wəd/	ad.(alsoforwards)向前a.向前的v.转交\r\n
fossil	/'fɔsəl/	n.化石\r\n
foster	/'fɔstə/	vt.养育;收养;怀抱;鼓励a.收养的n.养育者\r\n
foul	/faul/	a.污秽的;邪恶的v.弄脏;妨害;犯规n.犯规\r\n
found	/faʊnd/	vt.建立;创立;创办;使有根据;铸造;熔制\r\n
foundation	/faun'deiʃən/	n.基础,根本,建立,创立;地基,基金,基金会\r\n
fountain	/'fauntin/	n.泉水,喷泉,源泉\r\n
four	/fɔ:/	num.四pron./a.四(个,只...)\r\n
fourteen	/'fɔ:'ti:n/	num.十四,十四个\r\n
fox	/fɔks/	n.狐狸\r\n
fraction	/'frækʃən/	n.碎片,小部分,一点儿;分数\r\n
fracture	/'fræktʃə/	n.裂缝(痕);骨折v.(使)断裂,(使)折断\r\n
fragile	/'frædʒail/	a.易碎的,脆的,易损坏的;虚弱的,脆弱的\r\n
fragment	/'fræɡmənt/	n.碎片,小部分,片断\r\n
fragrant	/'freiɡrənt/	a.香的;芬芳的\r\n
frame	/freim/	n.框架;体格;骨架;组织;机构v.设计;制定\r\n
framework	/'freimwə:k/	n.构架;框架;结构;组织;机构\r\n
frank	/fræŋk/	a.坦白的,直率的\r\n
fraud	/frɔ:d/	n.欺诈,诈骗;欺骗(行为);骗子;假货\r\n
free	/fri:/	a.自由的;免费的;免税的;空闲的vt.释放\r\n
freedom	/'fri:dəm/	n.自由,自主,免除,特权\r\n
freeze	/fri:z/	v.使结冰,使凝固\r\n
freight	/freit/	n.货物,货运,运费\r\n
frequency	/'frikwənsi/	n.频率,周率\r\n
frequent	/'fri:kwənt,fri'kwent/	a.时常发生的,频繁的\r\n
fresh	/freʃ/	a.新鲜的,无经验的\r\n
friction	/'frikʃən/	n.磨擦,摩擦力\r\n
Friday	/ˈfraɪdeɪ,ˈfraɪdi/	n.星期五\r\n
fridge	/fridʒ/	n.(refrigerator的略语)冰箱\r\n
friend	/frend/	n.朋友\r\n
friendly	/'frendli/	a.友好的,友谊的\r\n
friendship	/ˈfrendʃɪp/	n.友谊,友好\r\n
fright	/frait/	n.恐怖\r\n
frighten	/'fraitən/	v.使惊恐\r\n
fringe	/frindʒ/	n.边缘;(窗帘)缘饰;额前垂发vt.饰…的边\r\n
frog	/frɔɡ/	n.蛙\r\n
from	/强frɔm,弱frəm/	prep.从,自从;由于;离;根据,按;去除\r\n
front	/frʌnt/	a.前面的,前部的n.正面;前线,战线v.面对\r\n
frontier	/'frʌntjə/	n.国境,边境;尖端,新领域\r\n
frost	/frɔst/	n.霜,霜冻,严寒\r\n
frown	/fraun/	v.皱眉\r\n
fruit	/fru:t/	n.水果,果实;成果,效果\r\n
fruitful	/'fru:tful/	a.多产的;果实累累的,富有成效的\r\n
frustrate	/frʌs'treit/	vt.挫败,阻挠,使灰心\r\n
fry	/frai/	v.油煎,油炸\r\n
fuel	/'fjuəl/	n.燃料vt.给…加燃料\r\n
fulfill	/ful'fil/	v.(fulfil)完成,履行,实践,满足\r\n
full	/ful/	a.(of)满的,充满的a./ad.完全,充分\r\n
fume	/fju:m/	n.(浓烈或难闻的）烟,气,汽\r\n
fun	/fʌn/	n.玩笑,娱乐;有趣的人(或事物)\r\n
function	/'fʌŋkʃən/	n.功能,作用;(pl.)职务;函数v.起作用\r\n
fund	/fʌnd/	n.资金,基金;存款,现款;(知识等的)累积\r\n
fundamental	/,fʌndə'mentəl/	a.基础的,基本的n.(pl.)基本原则,基本原理\r\n
funeral	/'fju:nərəl/	n.丧葬,葬礼\r\n
funny	/'fʌni/	a.滑稽的,可笑的\r\n
fur	/fə/	n.毛,毛皮\r\n
furious	/'fju:riəs/	a.狂怒的,狂暴的,猛烈的\r\n
furnace	/'fə:nis/	n.炉子,熔炉\r\n
furnish	/'fə:niʃ/	v.供应,提供;装备,布置\r\n
furniture	/'fə:nitʃə/	n.家具\r\n
further	/'fə:ðə/	ad./a.更远,更往前;进一步v.促进,增进\r\n
furthermore	/'fə:ðəmɔ:/	ad.而且,此外\r\n
fuse	/fju:z/	n.保险丝,导火线,引信v.熔化,熔合\r\n
fuss	/fʌs/	n./v.忙乱,大惊小怪\r\n
futile	/'fju:tail/	a.无效的,无用的,无希望的\r\n
future	/'fju:tʃə/	n.将来,未来;前途,前景a.将来的,未来的\r\n
gain	/ɡein/	v.获得;增加;表等走快n.增进,增加;收益\r\n
galaxy	/'ɡæləksi/	n.星系;(theGalaxy)银河(系);一群显赫的人\r\n
gallery	/'ɡæləri/	n.长廊,画廊,美术馆\r\n
gallon	/'ɡælən/	n.加仑\r\n
gallop	/'ɡæləp/	v./n.奔驰,飞奔\r\n
gamble	/'ɡæmbl/	n./v.投机,冒险;赌博\r\n
game	/ɡeim/	n.游戏,娱乐;比赛;(pl.)运动会vi.赌博\r\n
gang	/ɡæŋ/	n.一帮,一群,一伙\r\n
gaol	/dʒeil/	n.(jail)监狱;(不加冠词)监禁vt.使…坐牢\r\n
gap	/ɡæp/	n.缺口;差距;空白;缺乏\r\n
garage	/'ɡærɑ:dʒ,ɡə'r-/	n.车库,飞机库;修车厂\r\n
garbage	/'ɡɑ:bidʒ/	n.垃圾\r\n
garden	/'ɡɑ:dn/	n.(菜,花)园;公园\r\n
garlic	/'ɡɑ:lik/	n.蒜,大蒜粉\r\n
garment	/'ɡɑ:mənt/	n.(一件)衣服\r\n
gas	/ɡæs/	n.气体;煤气;汽油;毒气vt.毒(死);加油\r\n
gasoline	/'ɡæsəli:n/	n.(gasolene)汽油\r\n
gasp	/ɡɑ:sp,ɡæsp/	n.喘息,气喘v.喘息;气吁吁地说\r\n
gate	/ɡeit/	n.大门;入口;观众人数,门票收入\r\n
gather	/'ɡæðə/	v.聚集,聚拢;推测,推断\r\n
gauge	/ɡeidʒ/	n.标准尺寸;规格;量规,量表v.测量\r\n
gay	/ɡei/	a.快乐的,愉快的,色彩鲜艳的n.同性恋\r\n
gaze	/ɡeiz/	v./n.凝视,注视\r\n
gear	/ɡiə/	n.齿轮,传动装置v.(to)调整,使适合\r\n
gender	/'dʒendə/	n.(生理上的)性;(名词、代词等的)性\r\n
gene	/dʒi:n/	n.基因\r\n
general	/'dʒenərəl/	a.一般的,普通的;总的,大体的n.将军\r\n
generalize	/'dʒenərəlaiz/	v.(generalise)归纳,概括;推广,普及\r\n
generate	/'dʒenəreit/	vt.产生,发生;生殖\r\n
generation	/,dʒenə'reiʃən/	n.产生,发生;一代(人)\r\n
generator	/'dʒenəreitə/	n.发电机,发生器\r\n
generous	/'dʒenərəs/	a.宽宏大量的,慷慨的\r\n
genetic	/dʒi'netik/	a.遗传(学)的n./-s/遗传学\r\n
genius	/'dʒi:njəs/	n.天才\r\n
gentle	/'dʒentl/	a.和蔼的,文雅的,有礼貌的\r\n
gentleman	/'dʒentlmən/	n.绅士,先生\r\n
gently	/'dʒentli/	ad.文雅地,有礼貌地;轻轻地\r\n
genuine	/'dʒenjuin/	a.真正的,名副其实的\r\n
geography	/dʒi'ɔɡrəfi/	n.地理(学)\r\n
geology	/dʒi'ɔlədʒi/	n.地质(学)\r\n
geometry	/dʒi'ɔmitri/	n.几何(学)\r\n
germ	/dʒə:m/	n.微生物,细菌\r\n
gesture	/'dʒestʃə/	n.姿势,姿态,手势v.做手势\r\n
get	/ɡet/	v.获得,得到;使,使得;变得,成为;到达\r\n
ghost	/ɡəust/	n.鬼魂,幽灵\r\n
giant	/'dʒaiənt/	n.巨人a.巨大的\r\n
gift	/ɡift/	n.礼品,赠品;天赋,才能\r\n
gigantic	/,dʒai'ɡæntik/	a.巨大的,庞大的\r\n
giggle	/'ɡiɡl/	vi.／n.痴笑;咯咯地笑vt.咯咯地笑着说\r\n
girl	/ɡə:l/	n.少女,姑娘,女孩;女职员\r\n
give	/ɡiv/	v.给,授予;供给;献出,让步;捐赠;发表\r\n
glad	/ɡlæd/	a.高兴的,快活的;乐意的,情愿的\r\n
glamor	/'ɡlæmə/	n.(glamour)魅力;魔法vt.迷惑\r\n
glance	/ɡlɑ:ns,ɡlæns/	v.(at,over)扫视n.匆匆看,一瞥,一眼\r\n
glare	/ɡlεə/	vi.怒目而视;发射强光n.强光;怒视;炫耀\r\n
glass	/ɡlɑ:s,ɡlæs/	n.玻璃;玻璃杯;镜子;(pl.)眼镜\r\n
glide	/ɡlaid/	n./v.溜,滑行;(时间)消逝\r\n
glimpse	/ɡlimps/	n./v.一瞥,瞥见\r\n
glitter	/'ɡlitə/	n.光辉,灿烂v.闪闪发光;闪耀\r\n
global	/'ɡləubəl/	a.球形的;全球的,全世界的;全面的\r\n
globe	/ɡləub/	n.球体,地球仪;地球,世界\r\n
gloomy	/'ɡlu:mi/	a.阴暗的,阴沉的,令人沮丧的,阴郁的\r\n
glorious	/'ɡlɔ:riəs/	a.壮丽的,辉煌的;光荣的\r\n
glory	/'ɡlɔ:ri/	n.光荣,荣誉\r\n
glove	/ɡlʌv/	n.手套\r\n
glow	/ɡləu/	v.发热,发光,发红n.白热\r\n
glue	/ɡlu:/	n.胶,胶水v.胶合,粘贴\r\n
go	/ɡəu/	v.去,离开;走;放置;变成;运转n.围棋\r\n
goal	/ɡəul/	n.目的,目标;守门员,球门;进球\r\n
goat	/ɡəut/	n.山羊\r\n
god	/ɡɔd/	n.上帝(小写god泛指所有的“神,神像”)\r\n
gold	/ɡəuld/	n.金,黄金;金币;金黄色a.金的,金制的\r\n
golden	/'ɡəuldən/	a.金黄色的;贵重的,极好的\r\n
golf	/ɡɔlf/	n.高尔夫球\r\n
good	/ɡud/	a.好的;善良的;擅长的;乖的n.好处;利益\r\n
goodby	/,ɡud'bai/	int.(goodbye)再见\r\n
goodness	/'ɡudnis/	n.善良,仁慈;(食物等)精华int.天哪\r\n
goods	/ɡudz/	n.(pl.)货物,商品\r\n
goose	/ɡu:s/	n.(pl.geese)鹅,雌鹅,鹅肉\r\n
gorgeous	/'ɡɔ:dʒəs/	a.华丽的;灿烂的;美丽的;宜人的;棒的\r\n
gossip	/'ɡɔsip/	n./v.(说)闲话,闲聊\r\n
govern	/'ɡʌvən/	v.统治,管理;决定,支配\r\n
government	/'ɡʌvənmənt/	n.政府,内阁;管理,支配;政治,政体\r\n
governor	/'ɡʌvənə/	n.统治者,管理者,总督,州(省)长\r\n
gown	/ɡaun/	n.长袍,特殊场合穿的长服\r\n
grab	/ɡræb/	v./n.(at)抓(住);夺(得)\r\n
grace	/ɡreis/	n.优美,文雅;恩惠,恩泽;宽限,缓刑;感恩祷告\r\n
graceful	/'ɡreisful/	a.优美的,文雅的,大方的\r\n
gracious	/'ɡreiʃəs/	a.亲切的,客气的;宽厚的,仁慈的\r\n
grade	/ɡreid/	n.等级,级别;年级;分数v.分等,分级\r\n
gradual	/'ɡrædʒuəl/	a.逐渐的,逐步的\r\n
graduate	/'ɡrædjueit,-dʒu-/	n.大学毕业生,研究生v.大学毕业a.毕了业的\r\n
grain	/ɡrein/	n.谷物,谷类;颗粒,细粒\r\n
gramme	/ɡræm/	n.(gram)克\r\n
grammar	/'ɡræmə/	n.语法,语法书\r\n
grand	/ɡrænd/	a.盛大的,豪华的;重大的,主要的\r\n
grandmother	/'ɡrænd,mʌðə/	n.祖母,外祖母\r\n
grant	/ɡrɑ:nt,ɡrænt/	v.同意,准予;授予n.授予物;津贴;转让证书\r\n
grape	/ɡreip/	n.葡萄\r\n
graph	/ɡrɑ:f,ɡræf/	n.图表,曲线图\r\n
graphic	/'ɡræfik/	a.绘画似的,图解的,生动的\r\n
grasp	/ɡrɑ:sp,ɡræsp/	v./n.抓住,抓紧;掌握,领会\r\n
grass	/ɡrɑ:s,ɡræs/	n.草,草地\r\n
grateful	/'ɡreitful/	a.(to,for)感激的;感谢的\r\n
gratitude	/'ɡrætitju:d/	n.感激,感谢\r\n
grave	/ɡreiv/	n.坟墓a.严肃的,庄重的\r\n
gravity	/'ɡræviti/	n.重力,引力;严肃,庄重\r\n
graze	/ɡreiz/	vi.吃青草vt.放牧;擦伤;掠过.n.擦伤(处)\r\n
grease	/ɡri:s/	n.动物脂,油脂,润滑脂v.抹油,润滑\r\n
great	/ɡreit/	a.伟大的;重要的;大量的;很好的;美好的\r\n
greedy	/ɡri:di/	a.贪吃的,贪婪的,渴望的\r\n
green	/ɡri:n/	a.绿色的;生的;未成熟的n.绿色;蔬菜;植物\r\n
greenhouse	/'ɡri:nhaus/	n.温室\r\n
greet	/ɡri:t/	v.致敬,敬意,迎接;扑(鼻),入(耳),触(目)\r\n
greeting	/'ɡri:tiŋ/	n.问候,致敬\r\n
grey	/ɡrei/	n./a.(gray)灰色(的)\r\n
grief	/ɡri:f/	n.悲伤,悲痛;悲伤的事,悲痛的缘由\r\n
grieve	/ɡri:v/	v.使悲伤,使伤心\r\n
grim	/ɡrim/	a.严酷的,令人害怕的;不愉快的,讨厌的\r\n
grin	/ɡrin/	n./vi.露齿而笑,咧嘴一笑\r\n
grind	/ɡraind/	v.磨(碎),碾(碎)\r\n
grip	/ɡrip/	v./n.紧握,抓紧;掌握\r\n
groan	/ɡrəun/	v./n.呻吟\r\n
grocer	/'ɡrəusə/	n.食品商,杂货商\r\n
grope	/ɡrəup/	n./v.摸索,探索\r\n
gross	/ɡrəus/	a.总的,毛(重)的;粗鲁的,粗俗的n.总额\r\n
ground	/ɡraund/	n.地,地面,土地;场地,场所;理由,根据\r\n
group	/ɡru:p/	n.群,组v.分组\r\n
grow	/ɡrəu/	v.生长,成长;渐渐变成;栽培,种植;发展\r\n
grown-up	/ˌɡrəʊn ˈʌp , ˈɡrəʊn ʌp/	a.成长的,成熟的,成人的n.成年人\r\n
growth	/ɡrəuθ/	n.生长,增长,发展\r\n
guarantee	/,ɡærən'ti:/	n.保证,保证书v.保证,担保\r\n
guard	/ɡɑ:d/	v./n.保卫,守卫,提防n.哨兵,警卫,看守\r\n
guess	/ɡes/	v./n.猜测,推测;以为;猜想/同/surmise\r\n
guest	/ɡest/	n.客人,宾客,旅客\r\n
guidance	/'ɡaidəns/	n.引导,指导\r\n
guide	/ɡaid/	n.领路人;指南,导游v.领路;指导;支配;管理\r\n
guideline	/'ɡaidlain/	n.指导方针,指导原则,准则,标准\r\n
guilt	/ɡilt/	n.罪过,内疚\r\n
guilty	/'ɡilti/	a.(of)有罪的,内疚的\r\n
guitar	/ɡi'tɑ:/	n.吉他vi.弹吉他\r\n
gulf	/ɡʌlf/	n.海湾\r\n
gum	/ɡʌm/	n.树胶;口香糖\r\n
gun	/ɡʌn/	n.枪,炮,手枪\r\n
gut	/ɡʌt/	n./pl./胆量;内脏a.本能的vt.取出内脏\r\n
guy	/ɡai/	n.家伙,人\r\n
gymnasium	/dʒim'neiziəm/	n.(gym)体育馆,健身房\r\n
habit	/'hæbit/	n.习惯,习性,脾性\r\n
habitat	/'hæbitæt/	n.(动物的)栖息地,(植物的)产地\r\n
hail	/heil/	v.下雹;欢呼,欢迎n.雹\r\n
hair	/hεə/	n.毛发,头发;绒毛,毛状物\r\n
half	/hɑ:f,hæf/	n.半,一半a.一半的,不完全的ad.一半地\r\n
hall	/hɔ:l/	n.礼堂,会堂,办公大楼,门厅\r\n
halt	/hɔ:lt/	n.止步,停步,停止前进v.止步,(使)停止\r\n
ham	/hæm/	n.火腿\r\n
hamburger	/'hæmbə:ɡə/	n.汉堡包,牛肉饼\r\n
hammer	/'hæmə/	n.铁锤,槌,榔头v.锤击,敲打\r\n
hamper	/'hæmpə/	v.妨碍,阻碍,牵制\r\n
hand	/hænd/	n.手,人手,雇员;专门业人员;指针v.交\r\n
handbook	/'hændbuk/	n.手册,指南\r\n
handful	/'hændful/	n.一把;少数;一小撮\r\n
handicap	/'hændikæp/	v.妨碍n.(身体或智力方面的)缺陷;不利条件\r\n
handkerchief	/'hæŋkətʃif,-tʃi:f/	n.手帕\r\n
handle	/'hændl/	n.柄,把手,拉手v.处理,对待,操纵;触,抚养\r\n
handsome	/'hænsəm/	a.漂亮的,英俊的;慷慨的,数量可观的\r\n
handwriting	/'hænd,raitiŋ/	n.笔迹,手迹,书法\r\n
handy	/'hændi/	a.手边的,近便的;方便的\r\n
hang	/'hæŋ/	v.悬挂,垂吊;吊死,绞死\r\n
happen	/'hæpən/	v.(偶然)发生;碰巧,恰好\r\n
happy	/'hæpi/	a.快乐的,幸福的;乐意的;令人满意的\r\n
harassment	/'hærəsmənt/	n.骚扰,扰乱;烦恼,烦乱\r\n
harbor	/'hɑ:bə/	n.(harbour)海港;避难所v.隐匿,窝藏\r\n
hard	/hɑ:d/	a.坚硬的;结实的;困难的;难忍的;严厉的\r\n
harden	/'hɑ:dən/	v.(使)变硬\r\n
hardly	/'hɑ:dli/	ad.几乎不,简直不;仅仅\r\n
hardship	/'hɑ:dʃip/	n.艰难,困苦\r\n
hardware	/'hɑ:dwεə/	n.五金,金属制品;硬件\r\n
harm	/hɑ:m/	n./v.伤害,损害,危害\r\n
harmony	/'hɑ:məni/	n.协调,和谐;融洽\r\n
harness	/'hɑ:nis/	v.治理,利用n.马具,挽具\r\n
harsh	/hɑ:ʃ/	a.粗糙的;(声音)刺耳的;苛刻的,严酷的\r\n
harvest	/'hɑ:vist/	n.收获,收成;成果,后果v.收获,收割\r\n
haste	/heist/	n.匆忙,急速;草率v.赶快;匆忙\r\n
hasty	/'heisti/	a.匆忙的,仓促的;草率的\r\n
hat	/hæt/	n.帽子(一般指有边的帽子)\r\n
hatch	/hætʃ/	v.孵,孵出;策划,图谋n.舱口,小门\r\n
hate	/heit/	v.恨,憎恨;不愿,不喜欢n.恨,憎恶\r\n
hatred	/'heitrid/	n.憎恨,憎恶,怨恨\r\n
haul	/hɔ:l/	v.拖曳,拖运,用力拖\r\n
have	/hæv,弱həv,əv,v/	v.有,具有;体会,经受;从事;使;吃,喝\r\n
hawk	/hɔ:k/	n.鹰,隼\r\n
hay	/hei/	n.干草\r\n
hazard	/'hæzəd/	n.危险,冒险,危害v.冒险,拼命\r\n
he	/hi:,弱hi,i:,i/	pron.他;(不论性别的)一个人\r\n
head	/hed/	n.头;顶部;领导,首脑v.主管;位于..顶部\r\n
headache	/'hedeik/	n.头痛\r\n
heading	/'hediŋ/	n.标题\r\n
headline	/'hedlain/	n.大字标题,新闻标题\r\n
headmaster	/'hed'mɑ:stə/	n.校长\r\n
headquarters	/,hed'kwɔ:təz/	n.司令部,指挥部;总部,总局\r\n
heal	/hi:l/	v.治愈,愈合\r\n
health	/helθ/	n.健康,健康状况;卫生\r\n
healthy	/'helθi/	a.健康的,健壮的;有益健康的,卫生的\r\n
heap	/hi:p/	n.(一)堆,大量,许多v.(up)堆,堆起\r\n
hear	/hiə/	v.听见;审讯;(from)收到..的信/电话;听说\r\n
hearing	/'hiəriŋ/	n.听,倾听;听力;审讯\r\n
heart	/hɑ:t/	n.心(脏);内心,感情;热忱;中心,要点\r\n
heat	/hi:t/	n.热,热度;热烈,激烈v.(给)加热,(使)变热\r\n
heave	/hi:v/	v.(用力)举,提,拉;扔;拖;呕吐n.举起\r\n
heaven	/'hevən/	n.天,天空,天堂;(Heaven)上帝,神\r\n
heavy	/'hevi/	a.重的,重型的;沉重的,大量的,猛烈的\r\n
hedge	/hedʒ/	n.篱笆,树篱,障碍物v.用树篱围住\r\n
heel	/hi:l/	n.脚后跟,踵,鞋跟\r\n
height	/hait/	n.高,高度;(常pl.)高地,高处\r\n
heighten	/'haitən/	v.提高,升高\r\n
heir	/εə/	n.继承人\r\n
helicopter	/'helikɔptə/	n.直升(飞)机\r\n
hell	/hel/	n.地狱,阴间;苦境,极大痛苦\r\n
hello	/he'ləu,hə-/	int.英(美)喂,你好(用来打招呼或引起注意)\r\n
helmet	/'helmit/	n.头盔,钢盔\r\n
help	/help/	v.帮(援)助;有助于;/呼救/救命n.帮助(手)\r\n
helpful	/'helpful/	a.(to)有帮助的,有益的,有用的\r\n
hemisphere	/'hemi,sfiə/	n.半球\r\n
hen	/hen/	n.母鸡\r\n
hence	/hens/	ad.从此,今后;因此\r\n
henceforth	/'hens'fɔ:θ/	ad.今后\r\n
her	/hə:,弱ə:,hə,ə/	pron./she的宾格/她;/she的所有格/她的\r\n
herb	/hə:b,ə:b/	n.药草,(调味用的)香草,草本植物\r\n
herd	/hə:d/	n.群,兽群,牛群v.放牧,群集\r\n
here	/hiə/	ad.在(到,向)这里;这时;在这一点上\r\n
heritage	/'heritidʒ/	n.遗产,继承物;传统\r\n
hero	/'hiərəu/	n.英雄,勇士;男主角,男主人公\r\n
heroic	/hi'rəuik/	a.英雄的,英勇的,崇高的\r\n
heroin	/'herəuin/	n.海洛因\r\n
heroine	/'herəuin/	n.女英雄;女主角\r\n
hers	/hə:z/	pron./she的物主代词/她的(所有物)\r\n
herself	/hə:'self/	pron./反身代词/她自己;她亲自,她本人\r\n
hesitate	/'heziteit/	v.犹豫,踌躇;含糊,支吾\r\n
hi	/hai/	interj.(hey)嗨!喂!\r\n
hide	/haid/	v.隐藏,躲藏;隐瞒n.皮革,兽皮\r\n
hierarchy	/'haiə,rɑ:ki/	n.等级制度;统治集团,领导层\r\n
high	/hai/	a.高的,高度的,高级的,高尚的ad.高高地\r\n
highland	/'hailənd/	n.高地,高原\r\n
highlight	/'hailait/	v.使显著,使突出;强调n.最精彩的部分\r\n
highly	/'haili/	ad.高度地,很,非常;赞许地\r\n
highway	/'haiwei/	n.公路,大路\r\n
hijack	/'haidʒæk/	v.劫持,劫机,拦路抢劫\r\n
hike	/haik/	n.徒步旅行;增加vi.徒步旅行vt.提高\r\n
hill	/hil/	n.小山,山岗,高地;/pl./丘陵(地带)\r\n
him	/him,弱im/	pron.他(he的宾格形式)\r\n
himself	/him'self/	pron./反身代词/他自己;他本人\r\n
hinder	/ˈhɪndər/	v.(from)阻止,妨碍a.后面的\r\n
hinge	/hindʒ/	n.合页,铰链vi.依…而定\r\n
hint	/hint/	n.暗示,提示,线索v.暗示,示意\r\n
hip	/hip/	n.臀部,髋;屋脊\r\n
hire	/haiə/	n./v.雇用,租借\r\n
his	/hiz,弱iz/	pron./he的所有格/物主代词/他的(所有物)\r\n
historian	/his'tɔ:riən/	n.历史学家\r\n
historic	/his'tɔrik/	a.有历史意义的;历史的\r\n
historical	/his'tɔrikəl/	a.历史的;有关历史的\r\n
history	/'histəri/	n.历史,历史学;来历,经历\r\n
hit	/hit/	v.打,击;碰撞n.击中;成功而风行一时的事物\r\n
hitherto	/,hiðə'tu:/	ad.到目前为止,迄今\r\n
hobby	/'hɔbi/	n.业余爱好,嗜好,兴趣\r\n
hoist	/hɔist/	v.举起,升起,吊起\r\n
hold	/həuld/	v.拿着;保有;托住;举行;继续n.握住;船舱\r\n
holder	/'həuldə/	n.持有者,占有者;(台,架等)支持物\r\n
hole	/həul/	n.洞,孔\r\n
holiday	/'hɔlədi/	n.假日,节日,假期,休假\r\n
hollow	/'hɔləu/	a.空的,中空的;空洞的,空虚的v.挖空,凿空\r\n
holy	/'həuli/	a.神圣的,圣洁的\r\n
home	/həum/	ad.回家,在家n.家;家乡a.家庭的;家乡的\r\n
homework	/'həumwə:k/	n.(学生的)家庭作业、课外人员\r\n
homogeneous	/,hɔmə'dʒi:niəs/	a.同种类的,同性质的,有相同特征的\r\n
honest	/'ɔnist/	a.诚实的,正直的,老实的\r\n
honey	/'hʌni/	n.蜜,蜂蜜\r\n
honor	/'ɔnə/	n.(honour)尊敬,敬意;荣誉,光荣v.尊敬\r\n
honorable	/'ɔnərəbl/	a.(honourable)可敬的;荣誉的,光荣的\r\n
hook	/huk/	n.钩,吊钩,钩状物v.钩住\r\n
hop	/hɔp/	v.人单足跳;跳上(车等)n.蹦跳;短程飞行\r\n
hope	/həup/	n.希望,期望;希望的人或事v.希望,期望\r\n
hopeful	/'həupful/	a.给人希望的,抱有希望的\r\n
horizon	/hə'raizən/	n.地平线;眼界,见识\r\n
horizontal	/'hɔri'zɔntəl/	a.地平线的;水平的\r\n
horn	/hɔ:n/	n.(牛羊等的)角;号,喇叭;角状物;角制品\r\n
horrible	/'hɔrəbl/	a.令人恐惧的,可怕的;极讨厌的,糟透的\r\n
horror	/'hɔrə/	n.恐怖,战栗\r\n
horse	/hɔ:s/	n.马;跳马,鞍马v.骑马\r\n
horsepower	/'hɔ:s,pauə/	n./机/马力\r\n
hose	/həuz/	n.水龙带,软管v.用软管(淋浇,冲洗)\r\n
hospital	/'hɔspitəl/	n.医院\r\n
hospitality	/,hɔspi'tæləti/	n.好客,殷勤,款待\r\n
host	/həust/	n.主人;旅店老板;节目主持人;一大群,许多\r\n
hostage	/'hɔstidʒ/	n.人质\r\n
hostess	/'həustis/	n.女主人,女主持人\r\n
hostile	/'hɔstail,-təl/	a.敌对的,敌方的,敌意的\r\n
hot	/hɔt/	a.(炎)热的;辣的;急躁的;激动的;热衷的\r\n
hotel	/həu'tel/	n.旅馆\r\n
hound	/haund/	n.猎狗;卑鄙的人vt.用猎狗追,追逐\r\n
hour	/'auə/	n.小时,钟点;时刻;课时,工作时间\r\n
house	/haus,hauz/	n.房屋;商业机构;/H-/议院v.给...房子住\r\n
household	/'haushəuld/	n.家庭,家人a.家庭(务)的,家常的\r\n
housewife	/'hauswaif/	n.家庭主妇\r\n
housework	/'hauswə:k/	n.家务,家事(不可数)\r\n
housing	/ˈhaʊzɪŋ/	n.住房,住房供给;(外、阀)壳,防护罩\r\n
hover	/'hɔvə,'hʌ-/	vi.(鸟)盘旋,翱翔,(人)逗留在附近徘徊\r\n
how	/hau/	ad..(表示方法、手段、状态)怎样;如何\r\n
however	/hau'evə/	ad.然而,可是,不过,无论如何conj.无论\r\n
howl	/haul/	n.怒吼,嗥叫vi.(风等)怒吼,咆哮\r\n
huddle	/'hʌdl/	n./v.拥挤;聚集v.(因寒冷、害怕而)缩成一团\r\n
hug	/hʌɡ/	v./n.热烈拥抱,紧抱\r\n
huge	/hju:dʒ/	a.巨大的,庞大的\r\n
hum	/hʌm/	v.哼曲子;发嗡嗡声;忙碌n.嗡嗡声,嘈杂声\r\n
human	/'hju:mən/	a.人的,人类的n.人\r\n
humanity	/hju:'mænəti/	n.人类,人性,人情;(pl.)人文科学\r\n
humble	/ˈhʌmbl/	a.谦卑的,恭顺的;地位低下的v.降低,贬低\r\n
humid	/'hju:mid/	a.湿的,湿气重的\r\n
humidity	/hju:'midəti/	n.湿气,湿度\r\n
humiliate	/hju:'milieit/	v.使羞辱,使丢脸/同/disgrace\r\n
humor	/'hju:mə/	n.(humour)幽默,诙谐\r\n
humorous	/'hju:mərəs/	a.富于幽默感的,幽默的;滑稽的\r\n
hundred	/'hʌndrəd/	num.百,一百;/pl./许多a.一百的;许多\r\n
hunger	/'hʌŋɡə/	n./v.饥饿;渴望\r\n
hungry	/'hʌŋɡri/	a.饥饿的,渴望的\r\n
hunt	/hʌnt/	v./n.打猎,猎取;(for)搜索;寻找\r\n
hurl	/hə:l/	vt.猛投,力掷;大声叫骂\r\n
hurricane	/'hʌrikən/	n.飓风\r\n
hurry	/'hʌri,'hə:ri/	vi.匆忙vt.催促;急运(派)n.急(匆)忙\r\n
hurt	/hə:t/	n.伤痛,伤害v.刺痛,伤害;伤…的感情\r\n
husband	/'hʌzbənd/	n.丈夫\r\n
hut	/hʌt/	n.小屋,棚屋\r\n
hydrogen	/'haidrədʒən/	n.氢\r\n
hypocrisy	/hi'pɔkrisi/	n.伪善,虚伪\r\n
hypothesis	/hai'pɔθisis/	n.假说,假设,前提\r\n
hysterical	/hɪˈsterɪkl/	a.情绪异常激动的,歇斯底里的\r\n
I	/aɪ/	pron.(主格)我\r\n
ice	/ais/	n.冰;冰冻甜食vt.冰冻,使成冰\r\n
ice-cream	/'aiskri:m/	n.冰淇淋\r\n
idea	/ai'diə,'ai'diə/	n.想法,念头;概念,观念;意见,主意\r\n
ideal	/ai'diəl/	a.理想的;空想的;理想主义的;唯心的n.理想\r\n
identical	/ai'dentikəl/	a.(to.with)同一的,同样的\r\n
identification	/ai,dentifi'keiʃən/	n.识别,鉴别;证件;认同\r\n
identify	/ai'dentifai/	v.识别,鉴别;(with)把…和…看成一样\r\n
identity	/ai'dentəti/	n.身份;本体;特征;同一(性);一致;国籍;等式\r\n
ideology	/,aidi'ɔlədʒi,,idi-/	n.意识形态,(政治或社会的)思想意识\r\n
idiom	/'idiəm/	n.习语;成语方言;(艺术等的)风格,特色\r\n
idiot	/'idiət/	n.白痴;极蠢的人;笨蛋\r\n
idle	/'aidl/	a.空闲的,闲置的;懒散的v.空费,虚度\r\n
if	/ɪf/	conj.(用于连接宾语从句)是否;是不是\r\n
ignite	/iɡ'nait/	v.点火,引燃\r\n
ignorance	/'iɡnərəns/	n.无知,愚昧;不知道\r\n
ignorant	/'iɡnərənt/	a.无知的,愚昧的;不知道的\r\n
ignore	/iɡ'nɔ:/	v.不理,不顾,忽视\r\n
ill	/il/	a.有病的;坏的;恶意的ad.坏地;不利地\r\n
illegal	/ɪˈliːɡl/	a.不合法的,非法的\r\n
illiterate	/i'litərət/	a.文盲的,未受教育的\r\n
illness	/'ilnis/	n.病,疾病\r\n
illuminate	/i'lju:mineit/	vt.照亮,照明;用灯光装饰;说明,阐释\r\n
illusion	/i'lju:ʒən/	n.幻想,错误的观念;错觉,幻觉,假象\r\n
illustrate	/'iləstreit/	v.举例说明,阐明;图解,加插图\r\n
illustration	/,ilə'streiʃən/	n.说明;例证,插图;举例说明\r\n
image	/'imidʒ/	n.形象,声誉;印象;像;形象的描述,比喻\r\n
imaginary	/i'mædʒinəri/	a.想象的,虚构的\r\n
imagination	/i,mædʒi'neiʃən/	n.想象(力);空想,幻觉;想象出来的事物\r\n
imaginative	/i'mædʒinətiv/	a.富有想象力的,爱想象的\r\n
imagine	/i'mædʒin/	v.想象,设想,料想\r\n
imitate	/'imiteit/	v.模仿,仿效;仿造,伪造\r\n
imitation	/,imi'teiʃən/	n.模仿,仿效;仿制;仿造品\r\n
immediate	/i'mi:diət/	a.立即的,即时的;直接的,最接近的\r\n
immense	/i'mens/	a.广大的,巨大的;/口/极好的\r\n
immerse	/i'mə:s/	v.使沉浸在;使浸没\r\n
immigrant	/'imiɡrənt/	a.(从国外)移来的,移民的n.移民,侨民\r\n
immune	/i'mju:n/	a.免疫的,有免疫力的;不受影响的;豁免的\r\n
impact	/'impækt,im'pækt/	n.冲击,碰撞;影响v.影响;挤入,压紧\r\n
impair	/im'pεə/	v.损害,损伤;削弱,减少\r\n
impart	/im'pɑ:t/	vt.传授,给予;告知,通知\r\n
impatient	/im'peiʃənt/	a.不耐烦的,急躁的\r\n
imperative	/im'perətiv/	n.命令;需要;规则;祈使语气a.强制的;紧急的\r\n
imperial	/im'piəriəl/	a.帝国的,帝王的;(度量衡)英制的\r\n
impetus	/ˈɪmpɪtəs/	n.推动(力),促进\r\n
implement	/'impliment/	n.(pl.)工具,器具v.贯彻,实现\r\n
implication	/,impli'keiʃən/	n.含意,暗示,暗指;牵连\r\n
implicit	/im'plisit/	a.含蓄的;(in)固有的;无疑问的;绝对的\r\n
imply	/im'plai/	v.意指,含…意思,暗示\r\n
import	/im'pɔ:t,'impɔ:t/	v./n.进口,输入,(pl.)进口商品;要旨,含意\r\n
importance	/im'pɔ:təns/	n.重要,重要性\r\n
important	/im'pɔ:tənt/	a.重要的,重大的;有地位的,有权力的\r\n
impose	/im'pəuz/	v.征(税);(on)把…强加给\r\n
impossible	/im'pɔsəbl/	a.不可能的;难以忍受的,很难对付的\r\n
impress	/im'pres,'impres/	v.(on)印,盖印;留下印象,引人注目\r\n
impression	/im'preʃən/	n.印象,感想;盖印,压痕\r\n
impressive	/im'presiv/	a.给人深刻印象的,感人的\r\n
improve	/im'pru:v/	v.改善,改进,增进;好转,进步\r\n
improvement	/im'pru:vmənt/	n.改进,进步,增进;改进措施\r\n
impulse	/'impʌls/	v.推动n.推动;冲动,刺激\r\n
in	/in/	prep.在…里(内,上);用…(表示)ad.进,入\r\n
incentive	/in'sentiv/	n.刺激;动力;鼓励;诱因;动机\r\n
inch	/intʃ/	n.英寸\r\n
incidence	/'insidəns/	n.影响程度,影响范围;发生率\r\n
incident	/'insidənt/	n.事件,事变\r\n
incidentally	/,insi'dentəli/	ad.附带地,顺便提及\r\n
incline	/in'klain/	v.(使)倾斜;(使)倾向于n.斜坡,斜面\r\n
include	/in'klu:d/	v.包括,包含,计入\r\n
inclusive	/in'klu:siv/	a.(of)包括的,包含的;范围广的\r\n
income	/'inkʌm/	n.收入,收益,所得\r\n
incorporate	/in'kɔ:pəreit/	v.合并,纳入,结合a.合并的\r\n
increase	/in'kri:s,'inkri:s/	v./n.增加,增长,增进\r\n
increasingly	/in'kri:siŋli/	ad.不断增加地,日益\r\n
incredible	/in'kredəbl/	a.不可相信的,惊人的,不可思议的\r\n
incur	/in'kə:/	v.招致,惹起,遭受\r\n
indeed	/in'di:d/	ad.确实,实在;真正地,多么\r\n
independence	/,indi'pendəns/	n.独立,自主\r\n
independent	/,indi'pendənt/	a.(of)独立的,自主的\r\n
index	/'indeks/	n.(pl.indexes,indices)索引v.附以索引\r\n
indicate	/'indikeit/	v.指出,指示;表明,暗示\r\n
indication	/,indi'keiʃən/	n.指出,指示;表明,暗示\r\n
indicative	/in'dikətiv/	a.(of)指示的,暗示的\r\n
indifferent	/in'difərənt/	a.冷漠的,不关心的,不积极的\r\n
indignant	/in'diɡnənt/	a.愤慨的,愤慨不平的\r\n
indignation	/,indiɡ'neiʃən/	n.愤怒,愤慨\r\n
indispensable	/,indis'pensəbl/	a.(to,for)必不可少的,必需的\r\n
individual	/,indi'vidjuəl,-dʒəl/	a.个人的,单独的;独特的n.个人,个体\r\n
indoor	/'indɔ:/	a.室内的,户内的\r\n
induce	/in'dju:s,in'du:s/	v.引诱,劝使;引起,导致;感应\r\n
indulge	/in'dʌldʒ/	v.放任,纵容,沉溺;使(自己)纵情享受\r\n
industrial	/in'dʌstriəl/	a.工业的,产业的\r\n
industrialize	/in'dʌtriəlaiz/	v.(industrialise)(使)工业化\r\n
industry	/'indəstri/	n.工业,产业;勤劳,勤奋\r\n
inertia	/i'nə:ʃiə/	n.不活动,惰性;惯性\r\n
inevitable	/in'evitəbl/	a.不可避免的,必然发生的\r\n
infant	/'infənt/	n.婴儿,幼儿\r\n
infect	/in'fekt/	vt.传染,感染;影响(思想等)\r\n
infectious	/in'fekʃəs/	a.传染的,传染性的,有感染力的\r\n
infer	/in'fə:/	v.推论,推断\r\n
inference	/'infərəns/	n.推论,推理,推断;结论\r\n
inferior	/in'fiəriə/	a.下等的,下级的;劣等的,差的n.下级,晚辈\r\n
infinite	/'infinət/	a.无限的,无穷的n.无限\r\n
inflation	/in'fleiʃən/	n.通货膨胀\r\n
influence	/'influəns/	n.(on)影响,感化;势力,权势v.影响,感化\r\n
influential	/,influ'enʃəl/	a.有影响的;有权势的\r\n
inform	/in'fɔ:m/	v.(of,about)通知,告诉,报告;告发,告密\r\n
information	/,infə'meiʃən/	n.通知,报告;情报,资料,消息;信息\r\n
infrared	/,infrə'red/	a./n.红外线(的)\r\n
infrastructure	/'infrə,strʌktʃə/	n.基础结构,基础设施\r\n
ingenious	/in'dʒi:njəs/	a.机敏的;有独创性的;精致的;精巧制成的\r\n
ingredient	/in'ɡri:diənt/	n.(混合物的)组成部分,配料;成份,要素\r\n
inhabit	/in'hæbit/	vt.居住于,存在于;栖息于\r\n
inhabitant	/in'hæbitənt/	n.居民,住户\r\n
inhale	/in'heil/	v.吸入(气体等),吸(烟)\r\n
inherent	/in'hiərənt/	a.固有的,内在的,天生的\r\n
inherit	/in'herit/	vt.继承(金钱等),经遗传而得(性格、特征)\r\n
inhibit	/in'hibit/	vt.抑制,约束\r\n
initial	/i'niʃəl/	a.最初的,开头的;词首的n.词首大写字母\r\n
initiate	/i'niʃieit,i'niʃiət,-eit/	vt.开始,创始,发动;启蒙,使入门;引入\r\n
initiative	/i'niʃiətiv,-ʃətiv/	a.创始的,起始的n.第一步,创始,主动精神\r\n
inject	/in'dʒekt/	vt.注射(药液等);注入\r\n
injure	/'indʒə/	v.损害,损伤,伤害\r\n
injury	/'indʒəri/	n.伤害,损害\r\n
ink	/iŋk/	n.墨水,油墨\r\n
inland	/'inlənd,-lænd/	a./ad.国内,内地,内陆\r\n
inlet	/'inlet,-lit,in'let/	n.水湾,小湾;进口,入口\r\n
inn	/in/	n.小旅馆,客栈\r\n
inner	/'inə/	a.内部的,里面的;内心的\r\n
innocent	/'inəsənt/	a.(of)清白的,无罪的;无害的;单纯的,无知的\r\n
innovation	/,inəu'veiʃən/	n.改革,革新;新观念,新方法,新发明\r\n
innumerable	/i'nuj:mərəbl/	a.无数的,数不清的\r\n
input	/'input/	n./v.输入\r\n
inquiry	/in'kwaiəri/	n.(enquiry)询问,打听,调查\r\n
insect	/'insekt/	n.昆虫\r\n
insert	/in'sə:t,'insə:t/	v.插入,嵌入;登载n.插入物\r\n
inside	/,in'said,'in-/	a.里面的ad.在里面n.内部prep.在…里\r\n
insight	/'insait/	n.洞察力,见识\r\n
insist	/in'sist/	vi.(on)坚持要求,坚决主张,坚持\r\n
inspect	/in'spekt/	vt.检查,调查,视察\r\n
inspiration	/,inspə'reiʃən/	n.灵感;鼓舞,激励\r\n
inspire	/in'spaiə/	vt.鼓舞,激起;使产生灵感\r\n
install	/in'stɔ:l/	vt.(instal)安装,设置,安置;使就职,任命\r\n
installation	/,instə'leiʃən/	n.安装,设置;装置,设备\r\n
installment	/in'stɔ:lmənt/	n.(instalment)分期付款;(连载的)一期\r\n
instance	/'instəns/	n.例子,事例,例证\r\n
instant	/'instənt/	a.立即的;紧迫的;(食品)速溶的n.瞬间,时刻\r\n
instantaneous	/,instən'teinjəs/	a.瞬间的,即刻的\r\n
instead	/in'sted/	ad.代替,顶替\r\n
instinct	/'instiŋkt/	n.本能,直觉,天性\r\n
institute	/'institjut,-tu:t/	n.学会,研究所;学院v.设立,设置,制定\r\n
institution	/,insti'tju:ʃən/	n.公共机构;协会;学校;研究所;制度;惯例\r\n
instruct	/in'strʌkt/	v.教,教授;命令,指示\r\n
instruction	/in'strʌkʃən/	n.教授;指导;(pl.)用法说明(书),操作指南\r\n
instrument	/'instrumənt/	n.工具,仪器,器械;乐器\r\n
instrumental	/,instru'mentəl/	a.仪器的;器械的;乐器的;起作用的;有帮助的\r\n
insulate	/'insjuleit,'insə-/	vt.隔离,孤立;使绝缘,使绝热\r\n
insult	/in'sʌlt/	vt./n.侮辱,凌辱\r\n
insurance	/in'ʃuərəns/	n.保险,保险费,保险业\r\n
insure	/in'ʃuə/	vt.保险,给…保险;保证\r\n
intact	/in'tækt/	a.完整无缺的,未经触动的,未受损伤的\r\n
integral	/'intiɡrəl/	a.构成整体所必需的;完整的\r\n
integrate	/'intiɡreit/	v.(into,with)(使)成为一体,(使)结合在一起\r\n
integrity	/in'teɡrəti/	n.正直,诚实;完整,完全\r\n
intellectual	/,intə'lektjuəl/	n.知识分子a.智力的,理智的,有理解力的\r\n
intelligence	/in'telidʒəns/	n.智力,聪明;理解力;情报,消息,报导\r\n
intelligent	/in'telidʒent/	a.聪明的,明智的,理智的\r\n
intelligible	/in'telidʒəbl/	a.可理解的,明白易懂的,清楚的\r\n
intend	/in'tend/	vt.想要,打算,企图\r\n
intense	/in'tens/	a.强烈的,剧烈的;热烈的,热情的\r\n
intensity	/in'tensəti/	n.强烈,剧烈;强度\r\n
intensive	/in'tensiv/	a.加强的,集中的,深入细致的,精耕细作的\r\n
intention	/in'tenʃən/	n.意图,意向,目的\r\n
interact	/'intərækt/	v.互相作用,互相影响\r\n
intercourse	/'intəkɔ:s/	n.交流,交往,交际,性交\r\n
interest	/'intrist,'intər-/	n.(in)兴趣,重要性;利益v.(in)使发生兴趣\r\n
interesting	/'intristiŋ,'intər-/	a.有趣的,引人入胜的\r\n
interface	/'intəfeis/	n.接合部位,分界面v.(使)互相联系\r\n
interfere	/,intə'fiə/	v.(in)干涉,干预;(with)妨碍,打扰\r\n
interference	/,intə'fiərəns/	n.(in)干涉,干预;(with)妨碍,打扰\r\n
interim	/'intərim/	a.中间的,暂时的,临时的n.过渡时期,暂定\r\n
interior	/in'tiəriə/	a.内部的,里面的n.内部,内地\r\n
intermediate	/,intə'mi:djət,-dieit/	a.中间的,居间的;中级的n.中间体,媒介物\r\n
intermittent	/,intə'mitənt/	a.间歇的,断断续续的\r\n
internal	/in'tə:nəl/	a.内部的,内的;国内的,内政的\r\n
international	/,intə'næʃənəl/	a.国际的,世界(性)的,跨国的\r\n
internet	/'intənet/	n./the～/国际互联网,因特网\r\n
interpret	/in'tə:prit/	vt.解释,说明;口译\r\n
interrupt	/ˌɪntəˈrʌpt/	v.中断,遮断,阻碍;打断(话),打扰\r\n
intersection	/,intə'sekʃən/	n.相交,交叉;道路交叉口,十字路口\r\n
interval	/'intəvəl/	n.间隔,间歇;(幕间或工间)休息\r\n
intervene	/,intə'vi:n/	v.(in)干涉,干预;插入,介入\r\n
interview	/'intəvju:/	v./n.接见,会见;采访;面试\r\n
intimate	/'intimət/	a.亲密的,密切的n.熟友,熟人\r\n
intimidate	/in'timideit/	vt.胁迫,威胁(某人做某事)\r\n
into	/'intu:,-tu,-tə/	prep.到...里面,进入;成为(表示变化)\r\n
intricate	/'intrikət/	a.复杂的,错综的,难以理解的\r\n
intrigue	/in'tri:ɡ,'in-/	n.阴谋v.密谋,私通;激起…的兴趣;诡计取得\r\n
intrinsic	/in'trinsik,-kəl/	a.(指价值、性质)固有的,本质的,内在的\r\n
introduce	/,intrə'dju:s/	vt.介绍;引进,传入;提出(议案等)\r\n
introduction	/,intrə'dʌkʃən/	n.(to)介绍;传入,引进;导言,导论,绪论\r\n
intrude	/in'tru:d/	vi.闯入,侵入vt.把(思想等)强加于人;强挤入\r\n
intuition	/,intju:'iʃən/	n.直觉,直观;凭直觉而知的事物\r\n
invade	/in'veid/	vt.入侵,侵略,侵袭,侵扰\r\n
invalid	/'invəli:d/	n.病人,伤残人/ɪnˈvælɪd/a.有病的,伤残的;无效的\r\n
invaluable	/in'væljuəbl/	a.非常宝贵的,无价的\r\n
invariably	/ɪnˈveriəbli/	ad.不变地,永恒地,总是\r\n
invasion	/in'veiʒən/	n.入侵,侵略,侵犯\r\n
invent	/in'vent/	v.发明,创造;捏造,虚构\r\n
invention	/in'venʃən/	n.发明,创造,发明物\r\n
inventory	/'invəntəri,-tɔ:ri/	n.详细目录,存货,财产清册,总量\r\n
inverse	/'invə:s,in'v-,in'və:s/	a.相反的,倒转的,反转的n.相反之物v.倒转\r\n
invert	/in'və:t,'invə:t/	v.倒置,倒转,颠倒\r\n
invest	/in'vest/	vt.投资,投入(精力、时间等)\r\n
investigate	/in'vestiɡeit/	v.调查,调查研究\r\n
investment	/in'vestmənt/	n.投资,投资额\r\n
invisible	/in'vizəbl/	a.看不见的,无形的\r\n
invitation	/,invi'teiʃən/	n.邀请,招待;请柬\r\n
invite	/in'vait,'invait/	vt.邀请,招待\r\n
involve	/in'vɔlv/	v.卷入,陷入,连累;包含,含有,涉及\r\n
inward	/'inwəd/	ad.向内,在内a.向内的,在内的,里面的\r\n
iron	/'aiən/	n.铁,铁制品,烙铁,熨斗v.熨(衣),熨平\r\n
irony	/'aiərəni/	n.反话,讽刺,讽刺之事\r\n
irrespective	/,iri'spektiv/	a.不顾的,不考虑的,无关的\r\n
irrigate	/'iriɡeit/	vt.灌溉,修水利vi.进行灌溉\r\n
irritate	/'iriteit/	vt.激怒,恼火,使急躁\r\n
island	/'ailənd/	n.岛,岛屿;(道路上的)交通安全岛\r\n
isle	/ail/	n.小岛(用于诗歌中)\r\n
isolate	/'aisəleit,-lit/	vt.隔离,孤立\r\n
issue	/'iʃju:,'isju:/	n.问题,争端,发行(物),期号vt.发行,流出\r\n
it	/it/	pron.它;/作无人称动词的主语/\r\n
item	/'aitəm/	n.条(款),项目;一则(新闻),(戏剧的)节目\r\n
its	/its/	pron./it的所有格/它的\r\n
itself	/it'self/	pron.(it的反身代词)它自己,它本身\r\n
jacket	/'dʒækit/	n.短上衣,茄克衫\r\n
jam	/dʒæm/	n.阻塞,轧住;果酱v.(使)阻塞,(使)轧住不动\r\n
January	/ˈdʒænjueri/	n.一月\r\n
jar	/dʒɑ:/	n.罐坛,广口瓶\r\n
jargon	/'dʒɑ:ɡən,-ɡɔn/	n.行话\r\n
jaw	/dʒɔ:/	n.颌,颚\r\n
jazz	/dʒæz/	n.爵士乐\r\n
jealous	/'dʒeləs/	a.(of)妒忌的;猜疑的,警惕的\r\n
jeans	/dʒiːnz/	n.牛仔裤（又称bluejeans,dungarees等）\r\n
jet	/dʒet/	n.喷气发动机,喷气式飞机;喷口v.喷出,喷射\r\n
jewel	/'dʒu:əl/	n.宝石,宝石饰物\r\n
jewelry	/'dʒu:əlri/	n.(jewllery)(总称)珠宝\r\n
job	/dʒɔb/	n.工作,职位;零活,一件工作;任务,职责\r\n
jog	/dʒɔɡ/	v.慢跑\r\n
join	/dʒɔin/	v.参加,加入;联合,连接;和…在一起\r\n
joint	/dʒɔint/	n.接合处,接头;关节a.联合的,共同的,连接的\r\n
joke	/dʒəuk/	n.笑话,玩笑v.说笑话,开玩笑\r\n
jolly	/'dʒɔli/	a.欢乐的,高兴的\r\n
journal	/'dʒə:nəl/	n.定期刊物,杂志,日报;日志,日记\r\n
journalist	/'dʒə:nəlist/	n.记者,新闻工作者\r\n
journey	/'dʒə:ni/	n.旅行,旅程v.旅行\r\n
joy	/dʒɔi/	n.欢乐,喜悦;乐事,乐趣\r\n
judge	/dʒʌdʒ/	n.法官;裁判员;鉴定人vt.审判;评论,裁判\r\n
judgement	/'dʒʌdʒmənt/	n.(judgment)审判,判决;判断(力);看法,意见\r\n
judicial	/dʒu:'diʃəl/	a.司法的,法庭的,审判的;明断的,公正的\r\n
jug	/dʒʌɡ/	n.(有柄,小口,可盛水等的)大壶,罐,盂\r\n
juice	/dʒu:s/	n.(水果等)汁,液\r\n
July	/dʒuˈlaɪ/	n.七月\r\n
jump	/dʒʌmp/	v./n.跳跃,跳动,跳过;暴涨,猛增\r\n
junction	/'dʒʌŋkʃən/	n.连接,接合,交叉点,枢纽站,接头,中继线\r\n
June	/dʒuːn/	n.六月\r\n
jungle	/'dʒʌŋɡl/	n.丛林,生死地带\r\n
junior	/'dʒu:njə/	a./n.年少的/者,三年级的/学生,下级(的)\r\n
junk	/dʒʌŋk/	n.废物,旧货;舢板\r\n
jury	/'dʒuəri/	n.陪审团;全体评审员\r\n
just	/dʒʌst/	ad.正好地;刚才;只不过a.公正的,公平的\r\n
justice	/'dʒʌstis/	n.公正,公平;审判,司法\r\n
justify	/'dʒʌstifai/	v.证明...正当(或有理、正确),为...辩护\r\n
juvenile	/'dʒu:vənail,-nil/	n.青少年,少年读物a.青少年的,幼稚的\r\n
keen	/ki:n/	a.锋利的;敏锐的;敏捷的;(on)热心的,渴望的\r\n
keep	/ki:p/	v.保持,保存,遵守,经营,看守,拘留,维持\r\n
kettle	/'ketl/	n.水壶\r\n
key	/ki:/	n.钥匙;答案;关键;键a.主要的,关键的\r\n
keyboard	/'ki:bɔ:d/	n.键盘vt.用键盘输入(信息)\r\n
kick	/kik/	n./v.踢\r\n
kid	/kid/	n.小孩,儿童v.戏弄,取笑\r\n
kidnap	/'kidnæp/	vt.诱拐;绑架,劫持\r\n
kidney	/'kidni/	n.肾,肾脏\r\n
kill	/kil/	vt.杀死,消灭;破坏,毁灭;消磨(时间)\r\n
kilo	/'ki:ləu,'ki-/	n.(kilogram/kilogramme)千克\r\n
kilometer	/ˈkɪləˌmitɚ; kəˈlɑmətɚ/	n.(kilometer)公里,千米(略作km)\r\n
kin	/kin/	n.家族,亲属,血缘关系a.亲属关系的,同类的\r\n
kind	/kaind/	a.仁慈的,友好的,亲切的,和蔼n.种类\r\n
kindergarten	/ˈkɪndərɡɑːrtn/	n.幼儿园\r\n
kindness	/'kaindnis/	n.仁慈,亲切;好意;友好行为\r\n
king	/kiŋ/	n.君主,国王\r\n
kingdom	/'kiŋdəm/	n.王国,领域\r\n
kiss	/kis/	n./v.吻,接吻\r\n
kit	/kit/	n.成套工具,用具包,工具箱\r\n
kitchen	/'kitʃin/	n.厨房\r\n
kite	/kait/	n.风筝\r\n
knee	/ni:/	n.膝,膝盖\r\n
kneel	/ni:l/	v.跪,下跪\r\n
knife	/naif/	n.刀,餐刀v.用刀切,用匕首刺\r\n
knit	/nit/	v.编织,编结;接合,粘合\r\n
knob	/nɔb/	n.门把,(球形)把手,旋纽\r\n
knock	/nɔk/	v.敲,敲打,碰撞n.敲,击\r\n
knot	/nɔt/	n.(绳)结;(树)节;节(=海里/小时)v.打结\r\n
know	/nəu/	vt.知道,了解;认识;识别vi.知道,了解\r\n
knowledge	/'nɔlidʒ/	n.知识,学识;知道,了解\r\n
lab	/læb/	n.(laboratory)实验室\r\n
label	/'leibl/	n.标签v.把...称为;用标签于;用标签标明\r\n
labor	/'leibɚ/	n.(labour)工作,劳动;劳力v.劳动,苦干\r\n
lace	/leis/	n.花边;带子,鞋带v.系带,扎带\r\n
lack	/læk/	n./v.缺乏,不足\r\n
lad	/læd/	n.男孩,小伙子\r\n
ladder	/'lædə/	n.梯子,阶梯\r\n
lady	/'leidi/	n.女士,夫人\r\n
lag	/læɡ/	v./n.落后,滞后vt.用隔热材料覆盖(锅炉等)\r\n
lake	/leik/	n.湖泊,湖水\r\n
lamb	/læm/	n.羔羊,小羊;羔羊肉\r\n
lame	/leim/	a.跛的,(辩解、论据等)无说服力的\r\n
lamp	/læmp/	n.灯\r\n
land	/lænd/	n.陆地,土地,国家v.(使)靠岸(登陆,降落)\r\n
landlady	/'lænd,leidi/	n.女房东,女地主\r\n
landlord	/'lændlɔ:d/	n.房东,地主\r\n
lane	/lein/	n.小路,小巷,行车道\r\n
language	/'læŋɡwidʒ/	n.语言,术语,(运用语言的)方式、风格\r\n
lantern	/'læntən/	n.灯,灯笼\r\n
lap	/læp/	n.大腿,(跑道的)一圈,一段路程,工作阶段\r\n
lapse	/læps/	n.失误,流逝,丧失,下降v.失效,偏离,流逝\r\n
laptop	/'læptɔp/	n.膝上型电脑\r\n
large	/lɑ:dʒ/	a.大的,广大的,大规模的\r\n
largely	/'lɑ:dʒli/	ad.主要地,基本上;大量地,大规模地\r\n
laser	/'leizə/	n.激光\r\n
lash	/læʃ/	v.鞭打,摆动,捆扎n.鞭子,鞭打,睫毛,讽刺\r\n
last	/lɑ:st,læst/	a.最后的,刚过去的ad.最后n.最后v.持续\r\n
late	/leit/	a.迟的,晚的,晚期的;已故的ad.迟,晚\r\n
lately	/'leitli/	ad.最近,不久前\r\n
latent	/'leitənt/	a.潜在的,潜伏的,不易察觉的\r\n
later	/'leitə/	ad.后来,过后\r\n
lateral	/'lætərəl/	n.侧面的,旁边的\r\n
Latin	/ˈlætɪn/	a.拉丁的,拉丁文的n.拉丁语\r\n
latitude	/'lætitju:d/	n.纬度,行动或言论的自由(范围),(pl.)地区\r\n
latter	/'lætə/	a.后者的;后一半的,接近终了的n.后者\r\n
laugh	/lɑ:f,læf/	v.笑;(on)讥笑n.笑,笑声\r\n
laughter	/'lɑ:ftə,'læf-/	n.笑,笑声\r\n
launch	/lɔ:ntʃ,lɑ:ntʃ/	v.发射;使(船)下水,发动,开展n.发射,下水\r\n
laundry	/'lɔ:ndri,'lɑ:n-/	n.洗衣房(店);待洗衣物,所洗衣物\r\n
lavatory	/'lævətəri,-,tɔ:ri/	n.厕所,盥洗室\r\n
law	/lɔ:/	n.法律,法规,法学,规律,定律\r\n
lawn	/lɔ:n/	n.草地,草坪\r\n
lawyer	/'lɔ:jə/	n.律师\r\n
lay	/lei/	v.放,搁;下(蛋);铺设,敷设;设置,布置\r\n
layer	/'leiə/	n.层,层次;铺设者\r\n
layman	/'leimən/	n.外行\r\n
layoff	/'leiɔf/	n.临时解雇,操作停止,活动停止期间,失业期\r\n
layout	/ˈleɪaʊt/	n.安排,布局,设计;规划图,布局图\r\n
lazy	/'leizi/	a.懒惰的,懒散的\r\n
lead	/li:d/	v.领导;领先;通向,导致n.带领,引导;铅\r\n
leadership	/'li:dəʃip/	n.领导阶层,领导能力\r\n
leading	/'lidɪŋ/	a.领导的,指导的;第一位的;最主要的\r\n
leaf	/li:f/	n.叶子;(书刊的)一页,一张;金属薄片\r\n
leaflet	/'li:flit/	n.小叶,嫩叶;传单,活页\r\n
league	/li:ɡ/	n.同盟,联盟;联合会,社团\r\n
leak	/li:k/	v.漏,泄漏n.漏洞,漏隙;泄漏,漏出\r\n
lean	/li:n/	v.倾斜,屈身;倚,靠,依赖a.瘦的,无脂肪的\r\n
leap	/li:p/	v.跳,跳跃n.跳跃,飞跃\r\n
learn	/lə:n/	v.学习,学,学会;(of,about)听到,获悉\r\n
learned	/'lə:nid/	a.博学的,有学问的\r\n
learning	/'lə:niŋ/	n.知识,学问;学习\r\n
lease	/li:s/	vt.出租,租用n.租借,租期,租赁物\r\n
least	/li:st/	a.最小的;最少的ad.最小;最少\r\n
leather	/'leðə/	n.皮革,皮革制品\r\n
leave	/li:v/	v.离开;留下,忘带;让,听任;交付n.许可;假期\r\n
lecture	/'lektʃə/	n./v.演讲,讲课\r\n
left	/left/	n.左面,左方a.左边的,左面的;在左方的\r\n
leg	/leɡ/	n.腿,腿部;支柱;(旅程的)一段,一站\r\n
legacy	/'leɡəsi/	n.遗产,遗赠;先人(或过去)留下的东西\r\n
legal	/'li:ɡəl/	a.法律的,法定的;合法的,正当的\r\n
legend	/'ledʒənd/	n.传说,传奇\r\n
legislation	/,ledʒis'leiʃən/	n.法律(规);立法,法律的制定(或通过)\r\n
legitimate	/li'dʒitimət/	a.合法的;合理的,合乎逻辑的vt.使合法\r\n
leisure	/'leʒə/	n.空闲,闲暇;悠闲,安逸\r\n
lemon	/'lemən/	n.柠檬\r\n
lend	/lend/	vt.借给,贷(款)\r\n
length	/leŋθ,leŋkθ/	n.长,长度;一段,一节,程度,范围\r\n
lens	/lenz/	n.透镜,镜头\r\n
less	/les/	a./ad.更少的(地),更小的(地)\r\n
lesson	/'lesən/	n.(功)课;/pl./课程;教训\r\n
lest	/lest/	conj.惟恐,免得\r\n
let	/let/	v.让,允许,听任;设,假设;出租,租给\r\n
letter	/'letə/	n.信,函件;字母,文字\r\n
level	/'levəl/	n.水平,水准,等级v.弄平,铺平a.水平的\r\n
lever	/'li:və,'le-/	n.杆,杠杆,手段,途径,工具\r\n
levy	/'levi/	n.征收,征税,征兵v.征收,征集,征用\r\n
liability	/,laiə'biləti/	n.责任,义务;(pl.)债务\r\n
liable	/'laiəbl/	a.有...倾向的;可能遭受...的;有责任的\r\n
liberal	/'libərəl/	a.慷慨的,大方的;富足的;自由的,思想开放的\r\n
liberate	/'libəreit/	vt.解放,释放\r\n
liberty	/'libəti/	n.自由,自由权;特权\r\n
librarian	/lai'brεəriən/	n.图书管理员\r\n
library	/'laibrəri/	n.图书馆;藏书室;藏书,丛书,文库\r\n
license	/'laisəns/	n.(licence)许可证,执照v.准许,认可\r\n
lick	/lik/	vt.舔;(火焰或浪)掠过;打败n.舔;少量\r\n
lid	/lid/	n.盖\r\n
lie	/lai/	vi.躺,平放;处于;位于v.说谎n.谎话\r\n
life	/laif/	n.生命,生存;一生,寿命;生活;生物\r\n
lifetime	/'laiftaim/	n.一生,终生\r\n
lift	/lift/	v.升起,举起,消散n.电梯,上升,免费搭车\r\n
light	/'lait/	n.光;灯v.点燃;照亮a.轻(快);淡;明亮\r\n
lightning	/'laitniŋ/	n.闪电a.闪电般的,快速的\r\n
like	/laik/	v.喜欢prep.像;比如a.相像的n.像…一样\r\n
likelihood	/'laiklihud/	n.可能性\r\n
likely	/'laikli/	a.很可能的,有希望的ad.大概,多半\r\n
likewise	/'laikwaiz/	ad.同样地,照样地;又,也,而且\r\n
limb	/lim/	n.肢,翼,大树枝\r\n
limit	/'limit/	n.界限,限度,范围v.(to)限制,限定\r\n
limitation	/,limi'teiʃən/	n.限制,局限性\r\n
limited	/'limitid/	a.有限的,被限制的\r\n
limp	/limp/	a.柔软的,易曲的v./n.蹒跚,跛行\r\n
line	/lain/	n.线;路线,航线;排;线路;界线v.排队;加衬\r\n
linear	/'liniə/	a.线的,直线的,线状的;长度的;线性的\r\n
linen	/'linin/	n.亚麻布,亚麻布制品\r\n
liner	/'lainə/	n.班机,定期轮船,邮船\r\n
linger	/'liŋɡə/	v.逗留,徘徊,拖延,留恋,浪费光阴,苟延残喘\r\n
linguistic	/liŋ'ɡwistik,-kəl/	a.语言的,语言学的\r\n
link	/liŋk/	v.连接,联系n.环节,链环\r\n
lion	/'laiən/	n.狮子\r\n
lip	/lip/	n.嘴唇\r\n
liquid	/'likwid/	n.液体a.液体的,液态的\r\n
liquor	/'likə/	n.酒;溶液,液剂\r\n
list	/list/	n.表,目录,名单v.把…编列成表,列入表内\r\n
listen	/'lisən/	vi.倾听(与介词to并用,方可置宾语)\r\n
literacy	/'litərəsi/	n.有文化,有教养,读写能力\r\n
literally	/'litərəli/	ad.照字面意义,逐字地;确实\r\n
literary	/'litərəri/	a.文学上的,文学的;精通文学的,从事写作的\r\n
literature	/'litərətʃə/	n.文学,文学作品,文献,图书资料,印刷品\r\n
litre	/'li:tə/	n.(liter)升;公升(容量单位)\r\n
litter	/'litə/	n.垃圾,(杂乱的)废物v.使杂乱,乱丢\r\n
little	/'litl/	a.小,幼小;不多的ad./n.不多,几乎没有\r\n
live	/liv/	v.活着,生活,居住a.活的,生动的,直播的\r\n
lively	/'laivli/	a.活泼的,活跃的;栩栩如生的,真实的\r\n
liver	/’lɪvər/	n.肝,肝脏\r\n
living	/'liviŋ/	a.活的,有生命的,天然的,逼真的n.生活,生计\r\n
living-room	/ˈlɪvɪŋ ruːm,ˈlɪvɪŋ rʊm/	n.起居室\r\n
load	/ləud/	v.装(货),装载n.装载(量),负荷(量);(一)担\r\n
loaf	/ləuf/	n.一个面包\r\n
loan	/ləun/	n.贷款;出借,借出v.借出\r\n
lobby	/'lɔbi/	n.门廊,门厅,(会议)休息厅\r\n
local	/'ləukəl/	a.地方的,当地的;局部的\r\n
locality	/ləu'kæləti/	n.位置,地点\r\n
locate	/ləu'keit,'ləu/	v.查出,探出,查找…地点,使…坐落于,位于\r\n
location	/ləu'keiʃən/	n.位置,场所,定位,测位\r\n
lock	/lɔk/	n.锁v.锁,锁上\r\n
locker	/'lɔkə/	n.更衣箱\r\n
locomotive	/'ləukə,məutiv/	n.机车,火车头a.运动的,移动的,运载的\r\n
lodge	/lɔdʒ/	v.临时住宿,寄宿,寄存,容纳n.传达室,小旅馆\r\n
lofty	/'lɔfti,'lɔ:f-/	a.崇高的,高尚的;高傲的;极高的\r\n
log	/lɔɡ,lɔ:ɡ/	n.原木,圆木;航海日志\r\n
logic	/'lɔdʒik/	n.逻辑,逻辑学\r\n
logical	/'lɔdʒikəl/	a.逻辑的,符合逻辑的\r\n
lonely	/'ləunli/	a.孤独的,寂寞的;荒凉的,人迹稀少的\r\n
long	/lɔŋ,lɔ:ŋ/	a.长的,长时间的,长期的ad.长久,长期地\r\n
longitude	/'lɔndʒitju:d,-tu:d/	n.经度\r\n
look	/luk/	vi./n.看,注视v.好像,显得n.外表,脸色\r\n
loom	/lu:m/	n.织布机,织机v.隐现,(危险、忧虑等)迫近\r\n
loop	/lu:p/	n.圈,环\r\n
loose	/lu:s/	a.(宽)松的;不精确的;自由的,散漫的\r\n
loosen	/'lu:sən/	v.解开,放松\r\n
lord	/lɔ:d/	n.(Lord)上帝,主;主人,长官,君主,贵族\r\n
lorry	/'lɔ:ri,'lɔ:-/	n.卡车,运货汽车\r\n
lose	/lu:z/	v.丢失,迷路,输掉,亏本,失败,走慢,使沉湎于\r\n
loss	/lɔs,lɔ:s/	n.丧失,遗失;损失,损耗,亏损;失败\r\n
lot	/lɔt/	n.许多,大量;签,抽签;命运;场地\r\n
lottery	/'lɔtəri/	n.抽彩;碰运气的事,难于算计的事\r\n
loud	/laud/	a.大声的,响亮的;吵闹的,喧嚣的\r\n
loudspeaker	/'laud'spi:kə/	n.扬声器,扩音器\r\n
lounge	/laundʒ/	n.休息室,起居室,客厅\r\n
love	/lʌv/	n.爱,爱情,喜欢vt.爱,热爱;爱好,喜欢\r\n
lovely	/'lʌvli/	a.可爱的,好看的;令人愉快的,美好的\r\n
lover	/'lʌvə/	n.爱好者;(pl.)情侣\r\n
low	/ləu/	a.低,矮;低级的,下层的,卑贱的;低声的\r\n
lower	/'ləʊə/	a.较低的,下级的,下游的v.降下,放低\r\n
loyal	/'lɔiəl/	a.(to)忠诚的,忠贞的\r\n
loyalty	/'lɔiəlti/	n.忠诚,忠心\r\n
lubricate	/'lubrikeit/	v.润滑,加润滑油,行贿,收买\r\n
luck	/lʌk/	n.运气;好运,侥幸\r\n
lucky	/'lʌki/	a.幸运的,侥幸的\r\n
luggage	/'lʌɡidʒ/	n.行李,皮箱\r\n
lumber	/'lʌmbə/	n.木材,木料\r\n
lump	/lʌmp/	n.团,块v.(使)成团,(使)成块\r\n
lunar	/'lju:nə/	a.月亮的\r\n
lunch	/lʌntʃ/	n.午餐,(美)便餐\r\n
lung	/lʌŋ/	n.肺\r\n
lure	/ljuə/	n.吸引力,魅力,诱惑物vt.引诱,吸引\r\n
luxury	/'lʌkʃəri,'lʌɡʒəri/	n.奢侈,华贵;奢侈品a.奢华的,豪华的\r\n
machine	/mə'ʃi:n/	n.机器,机械v.用机器加工\r\n
machinery	/mə'ʃi:nəri/	n.(总称)机器,机械\r\n
mad	/mæd/	a.发疯的;狂热的,着迷的;恼火的,生气的\r\n
madame	/mɑ:'dɑ:m,'mædəm/	n.(madam)夫人,太太,女士\r\n
magazine	/,mæɡə'zi:n/	n.杂志,期刊\r\n
magic	/'mædʒik/	n.魔术,魔(魅)力,巫术a.有魔力的,魔术的\r\n
magistrate	/'mædʒistreit/	n.地方行政官,地方法官,治安官\r\n
magnet	/'mæɡnit/	n.磁体,磁铁\r\n
magnetic	/mæɡ'netik/	a.磁的,有磁性的;有吸引力的\r\n
magnificent	/mæɡ'nifisənt/	a.华丽的,高尚的,宏伟的\r\n
magnify	/'mæɡnifai/	vt.放大,扩大,夸大,夸张\r\n
magnitude	/'mæɡnitju:d/	n.大小,数量;巨大,广大\r\n
maid	/meid/	n.少女,处女,女仆\r\n
maiden	/'meidən/	n.少女,处女a.未婚的,纯洁的,无经验的\r\n
mail	/meil/	n.邮件v.邮寄\r\n
main	/mein/	a.主要的,总的n.总管道;干线\r\n
mainland	/'meinlənd/	n.大陆,本土\r\n
maintain	/mein'tein/	v.维修,保养,维持,供养,坚持,主张,支持\r\n
maintenance	/'meintənəns/	n.维修,保养,维持,保持,生活费用\r\n
majesty	/'mædʒisti/	n.雄伟,壮丽,庄严,威严;最高权威,王权\r\n
major	/'meidʒə/	a.主要的n.成年人,专业学生,主修课程v.主修\r\n
majority	/mə'dʒɔriti/	n.多数,大多数,成年,法定年龄\r\n
make	/meik/	n.(产品)来源,制法vt.制造,做成,准备\r\n
male	/meil/	n./a.男性(的),雄性(的)\r\n
malignant	/mə'liɡnənt/	a.恶性的,致命的;恶意的,恶毒的\r\n
mammal	/'mæməl/	n.哺乳动物\r\n
man	/mæn/	n.(pl.men)人;人类(单数,不加冠词);男人\r\n
manage	/'mænidʒ/	v.经营,管理,处理;设法,对付;操纵,运用\r\n
management	/'mænidʒmənt/	n.经营,管理;处理,操纵;管理部门\r\n
manager	/'mænidʒə/	n.经理,管理人\r\n
maneuver	/mə'nu:və/	n.(manoeuvre)机动;运用,操作;v.机动\r\n
manifest	/'mænifest/	v.表明,证明,显示a.明白的,明了的\r\n
manipulate	/mə'nipjuleit/	vt.(熟练地)使用,操作;(巧妙地)处理\r\n
mankind	/,mæn'kaind/	n.人类\r\n
manner	/'mænə/	n.方式;举止;(pl.)风度,礼貌;规矩;风俗\r\n
manual	/'mænjuəl/	a.手的,手工做的,体力的n.手册,指南\r\n
manufacture	/,mænju'fæktʃə/	v.制造,加工n.制造,制造业;产品\r\n
manuscript	/'mænjuskript/	n.手稿,原稿\r\n
many	/'meni/	a.许多的,多的pron.许多人或物,许多\r\n
map	/mæp/	n.地图,图vt.在地图上标示出,绘制地图\r\n
marble	/'mɑ:bl/	n.大理石,云石\r\n
march	/mɑ:tʃ/	v.(使)行军,(使)行进n.行军,行程\r\n
March	/mɑ:tʃ/	n.三月(略作Mar.)\r\n
margin	/'mɑ:dʒin/	n.页边空白;边缘;余地;幅度\r\n
marginal	/'mɑ:dʒinəl/	a.记在页边的,旁注的;(意识)边缘的\r\n
marine	/mə'ri:n/	a.海的,海生的;船舶的,航海的\r\n
marital	/'mæritəl/	a.婚姻的,夫妻之间的\r\n
mark	/mɑ:k/	n.痕迹;记号;分数v.标记,打分,使有特色\r\n
market	/'mɑ:kit/	n.集市,市场;销路,需求(量)v.销售\r\n
marriage	/'mæridʒ/	n.结婚,婚姻;结婚仪式\r\n
married	/'mærid/	a.已婚的,夫妇的;(to)与…结婚的\r\n
marry	/'mæri/	v.结婚,嫁,娶\r\n
marvelous	/ˈmɑːvələs/	a.(marvellous)惊人的,奇迹般的,妙极的\r\n
Marxist	/ˈmɑːksɪst/	a.马克思主义的n.马克思主义者\r\n
masculine	/'mæskjulin/	a.男性的,似男性的;［语法］阳性的\r\n
mask	/mɑ:sk,mæsk/	n.面具,面罩;假面具,伪装v.掩饰,化装\r\n
mass	/mæs/	n.大量,众多;团,块;(pl.)群众,民众;质量\r\n
massacre	/'mæsəkə/	vt.残杀,集体屠杀n.残杀,大屠杀\r\n
massive	/'mæsiv/	a.大而重的,厚实的,粗大的;大规模的,大量的\r\n
master	/'mɑ:stə,'mæstə/	n.男主人;师傅;硕士v.精通,控制a.主要的\r\n
masterpiece	/'mɑ:stəpi:s,'mæs-/	n.杰作,名著\r\n
mat	/mæt/	n.席子,垫子\r\n
match	/mætʃ/	n.火柴;比赛,竞赛;对手,配偶v.匹配,相称\r\n
mate	/meit/	n.伙伴,同事,同伴,配偶v.结伴,配对,交配\r\n
material	/məˈtɪriəl/	n.材料,原料,资料a.物质的,肉体的,实质性的\r\n
mathematical	/,mæθi'mætikəl/	a.数学的;数学上的\r\n
maths	/mæθs/	n.(mathematics/math)数学\r\n
matter	/'mætə/	n.物质,物体;毛病,麻烦;事情v.有关系,要紧\r\n
mature	/mə'tjuə/	a.成熟的,熟的;成年人的v.(使)成熟\r\n
maximum	/'mæksiməm/	n.最大值,极限a.最大的,最高的\r\n
may	/mei/	aux.v.可能,也许;可以,被允许;祝,愿\r\n
May	/mei/	n.五月\r\n
maybe	/'meibi/	adv.可能;大概;也许\r\n
mayor	/'mεə/	n.市长\r\n
me	/mi:,弱mi/	pron./I的宾格/我\r\n
meadow	/'medəu/	n.草地,牧场\r\n
meal	/mi:l/	n.膳食,一餐\r\n
mean	/mi:n/	v.表示…的意思a.卑鄙的;平均的n.平均值\r\n
meaning	/'mi:niŋ/	n.意思,意义,含义;重要性,价值\r\n
means	/mi:nz/	n.方法,手段\r\n
meantime	/'mi:n'taim/	n.(meanwhile)其间,其时ad.同时,当时\r\n
meanwhile	/'mi:nwail/	n.其时,其间ad.当时,与此同时\r\n
measure	/'meʒə/	v.测量,分派,权衡n.尺寸,量度器,措施,办法\r\n
meat	/mi:t/	n.(食用)肉类\r\n
mechanic	/mi'kænik/	n.技工,机修工\r\n
mechanical	/mi'kænikəl/	a.机械的,由机构制成的;机械似的,呆板的\r\n
mechanism	/'mekənizəm/	n.机械装置,机构;机制\r\n
medal	/'medəl/	n.奖章,勋章,纪念章\r\n
medical	/'medikəl/	a.医学的,医疗的,医药的;内科的\r\n
medicine	/'medisin/	n.内服药,医药;医术;医学,内科学\r\n
medieval	/,medi'i:vəl,,mi:-/	a.中世纪的,中古(时代)的,老式的,原始的\r\n
meditate	/'mediteit/	v.想,考虑,(尤指宗教上的)沉思,冥想\r\n
meditation	/,medi'teiʃən/	n.熟虑;(尤指宗教的)默想,沉思;(pl.)冥想录\r\n
medium	/'mi:diəm,-djəm/	n.(pl.media)媒体,方法,媒介,介质a.中等的\r\n
meet	/mi:t/	n.会,集会v.遇见;会谈;迎接;满足;符合\r\n
meeting	/'mi:tiŋ/	n.会议,集合,汇合,会见,接见,汇合点\r\n
melody	/'melədi/	n.旋律,曲调;悦耳的音乐\r\n
melon	/'melən/	n.甜瓜\r\n
melt	/melt/	v.(使)融化,(使)熔化\r\n
member	/'membə/	n.成员,会员\r\n
membership	/'membəʃip/	n.会员资格,成员资格\r\n
memo	/'meməu/	n.(memorandum)备忘录\r\n
memorial	/mi'mɔ:riəl,-'məu-/	a.记忆的,纪念的n.纪念物,纪念碑,纪念馆\r\n
memory	/'meməri/	n.记忆,记忆力;回忆;存储(器)\r\n
menace	/'menəs/	vt./n.有危险性的人(或物);威胁,威吓\r\n
mend	/mend/	v.修理,缝补;改正,改进\r\n
mental	/'mentəl/	a.精神的,思想的,心理的,智力的,脑力的\r\n
mention	/'menʃən/	v./n.提及,说起\r\n
menu	/'menju:,mə'nju:/	n.菜单\r\n