merchandise	/'mə:tʃəndaiz,-dais/	n.商品,货物\r\n
merchant	/'mə:tʃənt/	n.商人,零售商\r\n
mercury	/'mə:kjuri/	n.水银,汞\r\n
mercy	/'mə:si/	n.仁慈,怜悯,宽恕\r\n
mere	/miə/	a.纯粹的;仅仅,只不过\r\n
merely	/'miəli/	adv.仅仅,只不过\r\n
merge	/mə:dʒ/	v.(使)结合,(使)合并,(使)合为一体\r\n
merit	/'merit/	n.优点,价值,功绩v.值得,应得\r\n
merry	/'meri/	a.欢乐的,愉快的\r\n
mess	/mes/	n.混乱,混杂,脏乱v.弄脏,弄乱,搞糟\r\n
message	/'mesidʒ/	n.消息,信息,通讯,启示,教训,广告词,预言\r\n
messenger	/'mesindʒə/	n.送信者,使者,传令兵\r\n
metal	/'metəl/	n.金属,金属制品\r\n
metaphor	/'metəfə/	n.隐喻,暗喻\r\n
method	/'meθəd/	n.方法,办法\r\n
metre	/'mi:tə/	n.(meter)米,公尺;仪表,计量器\r\n
metric	/'metrik/	a.米制的,公制的\r\n
metropolitan	/,metrə'pɔlitən/	a.首都的,主要都市的,大城市\r\n
microphone	/'maikrəfəun/	n.话筒,扩音器\r\n
microscope	/'maikrəskəup/	n.显微镜\r\n
middle	/'midl/	n./a.中间(的),当中(的)\r\n
midst	/midst/	n.中间,当中\r\n
might	/mait/	aux.v.可能,也许n.力量,威力,权力\r\n
migrate	/mai'ɡreit,'maiɡ-/	v.迁移,移居(国外)\r\n
mild	/maild/	a.温和的,轻微的,味淡的,不含有害物质的的\r\n
mile	/mail/	n.英里,哩,海里\r\n
militant	/'militənt/	a.好战的,富于战斗性的n.斗士\r\n
military	/'militəri/	a.军事的,军用的,军队的\r\n
milk	/milk/	n.牛奶;(植物流出的)白色乳液v.挤奶\r\n
mill	/mil/	n.磨粉机,磨坊;作坊,工厂\r\n
millimeter	/'mili,mi:tə/	n.(millimetre)毫米\r\n
million	/'miljən/	num./n.百万,百万个\r\n
millionaire	/,miljə'nεə/	n.百万富翁\r\n
mind	/maind/	n.精神,理智,意见,记忆力v.注意,介意,反对\r\n
mine	/main/	pron.(I的物主代词)我的(东西)n.矿v.采矿\r\n
mineral	/'minərəl/	n.矿物,矿石a.矿物的,矿质的\r\n
mingle	/'miŋɡl/	v.(使)混合\r\n
miniature	/'miniətʃə/	n.缩小的模型,缩图a.微型的,缩小的\r\n
minimize	/'minimaiz/	v.(minimize)使减少到最少,使降到最低\r\n
minimum	/'miniməm/	n.最小值,最低限度a.最小的,最低的\r\n
minister	/'ministə/	n.部长,大臣\r\n
ministry	/'ministri/	n.(政府的)部;牧师\r\n
minor	/'mainə/	a.较小的,较小的n.兼修学科v.(in)兼修\r\n
minority	/mai'nɔrəti,mi-/	n.少数,少数派,少数民族\r\n
minus	/'mainəs/	a.负的,减的prep.减去n.负号,减号\r\n
minute	/'minit/	n.分钟,片刻;(pl.)会议记录a.微小的\r\n
miracle	/'mirəkl/	n.奇迹,令人惊奇的人(或事)\r\n
mirror	/'mirə/	n.镜子;反映,反射v.反映,反射\r\n
mischief	/'mistʃif/	n.损害,伤害,危害;恶作剧,胡闹;灾祸\r\n
miserable	/'mizərəbl/	a.痛苦的,悲惨的\r\n
misery	/'mizəri/	n.痛苦,悲惨,不幸\r\n
misfortune	/mis'fɔ:tʃən/	n.不幸,灾祸,灾难\r\n
mislead	/,mis'li:d/	v.把…带错路,使误入岐途\r\n
miss	/mis/	n.小姐v.思念,未击中,错过,漏掉,逃脱\r\n
missile	/'misail,-səl/	n.导弹,发射物\r\n
missing	/'misiŋ/	a.漏掉的,失去的,失踪的\r\n
mission	/'miʃən/	n.使命,任务;使团,代表团\r\n
missionary	/'miʃənəri/	a.教会的,传教(士)的n.传教士\r\n
mist	/mist/	n.薄雾,霭\r\n
mistake	/mi'steik/	n.错误,过失,误解v.弄错;(for)把…误认为\r\n
mistress	/'mistris/	n.女主人;主妇;情妇,情人\r\n
misunderstand	/,misʌndə'stænd/	v.误解,误会\r\n
mix	/miks/	v.使混合;混淆\r\n
mixture	/'mikstʃə/	n.混合;混合物,混合剂\r\n
moan	/məun/	n.呻吟声,悲叹声v.呻吟,抱怨,悲叹\r\n
mob	/mɔb/	n.乌合之众(尤指暴力者)vi.围攻,聚众闹事\r\n
mobile	/'məubail/	a.可动的,活动的,运动的\r\n
mobilize	/'məubilaiz/	v.(mobilise)动员,赋予可动性\r\n
mock	/mɔk/	v.嘲笑a.假的,模拟的n.(常pl.)模拟考试\r\n
mode	/məud/	n.方式,式样\r\n
model	/'mɔdəl/	n.样式,型;模范;模型,原型;模特v.模仿\r\n
moderate	/'mɔdərət,'mɔdəreit/	a.有节制的,中等的,适度的,温和的,稳健的\r\n
modern	/'mɔdən/	a.现代的,近代的,新式的\r\n
modernization	/,mɔdənai'zeiʃən/	n.(modernisation)现代化\r\n
modest	/'mɔdist/	a.谦虚的,有节制的\r\n
modify	/'mɔdifai/	v.更改,修改,修饰\r\n
module	/'mɔdju:l,-dʒu:l/	n.组件,模块,模件;(航天器的)舱\r\n
moist	/mɔist/	a.潮湿的,湿润的,多雨的\r\n
moisture	/'mɔistʃə/	n.潮湿,湿气,湿度\r\n
molecule	/'mɔlikjul/	n.分子\r\n
moment	/'məumənt/	n.片刻,瞬间,时刻\r\n
momentum	/məu'mentəm/	n.动力,要素\r\n
monarch	/'mɔnək,-ɑ:k/	n.帝王,君主,最高统治者\r\n
Monday	/ˈmʌndeɪ,ˈmʌndi/	n.星期一\r\n
monetary	/'mʌnitəri/	a.金融的,货币的\r\n
money	/'mʌni/	n.货币,钱\r\n
monitor	/'mɔnitə/	n.班长;监听器,监视器v.监控,监测\r\n
monkey	/'mʌŋki/	n.猴子\r\n
monopoly	/mə'nɔpəli/	n.垄断,专卖,专利权,专利事业\r\n
monotonous	/mə'nɔtənəs/	a.单调的,无变化的\r\n
monster	/'mɔnstə/	n.怪物,妖怪,畸形的动植物\r\n
month	/mʌnθ/	n.月,月份\r\n
monthly	/'mʌnθli/	a.每月的ad.每月一次,按月n.月刊\r\n
monument	/'mɔnjumənt/	n.纪念碑,纪念馆,遗迹,不朽的业绩\r\n
mood	/mu:d/	n.心情,情绪;语气\r\n
moon	/mu:n/	n.(加the)月球,月亮;卫星\r\n
moral	/'mɔrəl,'mɔ:-/	a.道德(上)的,精神上的n.寓意,教育意义\r\n
morality	/mə'ræləti,mɔ:-/	n.道德,美德\r\n
more	/mɔ:/	a.更多的n.更多的人(或东西)ad.更,更多\r\n
moreover	/mɔ:'rəuvə/	conj./ad.再者,加之,而且\r\n
morning	/'mɔ:niŋ/	n.早晨,上午\r\n
mortal	/'mɔ:təl/	a.致命的;终有一死的;人世间的n.凡人\r\n
mortgage	/'mɔ:ɡidʒ/	n./v.抵押(借款)\r\n
mosaic	/məu'zeiik/	n.马赛克;镶嵌体\r\n
mosquito	/mə'ski:təu/	n.蚊子\r\n
moss	/mɔs/	n.苔,藓,地衣\r\n
most	/məust/	a.最多的;大多数的ad.最;极其n.大多数\r\n
mostly	/'məustli/	ad.几乎全部地;主要地,大部分,基本上\r\n
motel	/məu'tel/	n.(附有停车场的)汽车旅馆\r\n
mother	/'mʌðə/	n.母亲\r\n
motion	/'məuʃən/	n.运动,动;提议,动议v.提议,动议\r\n
motivate	/'məutiveit/	vt.促动;激励,鼓励,作为…的动机\r\n
motive	/'məutiv/	n.动机,目的a.发动的,运动的\r\n
motor	/'məutə/	n.发动机,电动机\r\n
mould	/məuld/	n.(mold)模子,铸型v.浇铸,造型,塑造\r\n
mount	/maunt/	v.登上;安装n.支架,底板;(用于山名前)山峰\r\n
mountain	/'mauntin/	n.山\r\n
mourn	/mɔ:n,məun/	v.哀悼,忧伤\r\n
mouse	/maus,mauz/	n.(pl.mice)鼠,耗子\r\n
mouth	/mauθ/	n.口,嘴\r\n
move	/mu:v/	v.移动,迁移;活动;感动n.移动,活动,行动\r\n
movement	/'mu:vmənt/	n.运动,活动;移动,迁移\r\n
movie	/'mu:vi/	n.电影,电影院\r\n
much	/mʌtʃ/	a.多的,大量的ad.十分,非常;到极大程度\r\n
mud	/mʌd/	n.泥,泥浆v.弄脏,使沾污泥\r\n
mug	/mʌɡ/	n.(有柄的)大茶杯\r\n
multiple	/'mʌltipl/	a.多样的,多重的n.倍数v.成倍增加\r\n
multiply	/'mʌltiplai/	v.(by)乘,使相乘;倍增,增加,繁殖\r\n
multitude	/'mʌlti,tju:d,-,tu:d/	n.众多,大量\r\n
municipal	/mju:'nisipəl/	a.市(立,政)的;地方性的,地方自治的\r\n
murder	/'mə:də/	v./n.谋杀,凶杀\r\n
murmur	/'mə:mə/	v./n.小声说(话);小声抱怨,咕哝\r\n
muscle	/'mʌsl/	n.肌肉,体力\r\n
muscular	/'mʌskjulə/	a.肌肉的;肌肉发达的;强健的\r\n
museum	/mju:'ziəm/	n.博物馆,展览馆\r\n
mushroom	/'mʌʃru:m,-rum/	n.蘑菇vt.迅速生长,迅速增加,采蘑菇\r\n
music	/'mju:zik/	n.音乐,乐曲,乐谱\r\n
musical	/'mju:zikəl/	a.音乐的;有音乐才能的n.音乐片\r\n
musician	/mju:'ziʃən/	n.音乐家,乐师\r\n
must	/mʌst/	aux.&v.必须;很可能;一定要n.必须做的事\r\n
mute	/mju:t/	a.哑的,缄默的n.哑巴;弱音器v.减弱…的声音\r\n
mutter	/'mʌtə/	n.喃喃而语,小声低语;抱怨v.低声说,抱怨\r\n
mutton	/'mʌtən/	n.羊肉\r\n
mutual	/'mju:tʃuəl,-tjuəl/	a.相互的,彼此的;共同的,共有的\r\n
my	/maɪ/	pron.(I的所有格)我的\r\n
myself	/mai'self/	pron./反身代词/我自己;我亲自\r\n
mysterious	/mi'stiəriəs/	a.神秘的,可疑的,难理解的\r\n
mystery	/'mistəri/	n.神秘,神秘的事物;神秘小说,侦探小说\r\n
myth	/miθ/	n.神话;虚构的理论\r\n
nail	/neil/	n.指甲,爪;钉v.将…钉牢,钉住\r\n
naive	/nɑ:'i:v,nai-/	a.天真的\r\n
naked	/'neikid/	a.裸体的,无遮敝的,无掩饰的\r\n
name	/neim/	n.名字(称/声/义)vt.给…取名;列举;提名\r\n
namely	/'neimli/	ad.即,也就是\r\n
nap	/næp/	n.小睡,打盹\r\n
napkin	/'næpkin/	n.餐巾,餐巾纸,<英>尿布\r\n
narrative	/'nærətiv/	a.叙述性的n.叙述\r\n
narrow	/'nærəu/	a.狭窄的,狭的,狭隘的\r\n
nasty	/'nɑ:sti,'næs-/	a.肮脏的,卑劣的,下流的;令人厌恶的\r\n
nation	/'neiʃən/	n.民族,国家\r\n
national	/'næʃənəl/	a.民族的,国家的,国立的\r\n
nationality	/,næʃən'æliti/	n.国籍,民族\r\n
native	/'neitiv/	a.本地的,本国的;天生的n.本地人,本国人\r\n
natural	/'nætʃərəl/	a.正常的;自然界的,天然的,天赋的,固有的\r\n
nature	/'neitʃə/	n.自然界,大自然;性质,本性,天性\r\n
naughty	/'nɔ:ti/	a.顽皮的,淘气的\r\n
naval	/'neivəl/	n.海军的,军舰的\r\n
navigation	/,nævi'ɡeiʃən/	n.航海,航空;导航,领航\r\n
navy	/'neivi/	n.海军\r\n
near	/niə/	a.近的,接近的;亲近的prep.靠近ad.接近\r\n
nearby	/'niə'bai/	a.附近的ad.在附近prep.在…附近\r\n
nearly	/'niəli/	ad.差不多,几乎\r\n
neat	/ni:t/	a.整洁的,干净的,优美的,精致的\r\n
necessary	/'nesisəri/	a.必需的,必要的;必然的n.必需品\r\n
necessitate	/ni'sesi,teit,nə-/	v.使成为必要,需要\r\n
necessity	/ni'sesəti,nə-/	n.必要性,需要;必然性;(pl.)必需品\r\n
neck	/nek/	n.颈脖\r\n
necklace	/'neklis/	n.项链,项圈\r\n
need	/ni:d/	aux.v./v.需要;必须n.需要;贫困,困窘\r\n
needle	/'ni:dl/	n.针,指针,针状物\r\n
negative	/'neɡətiv/	a.否定的,消极的,阴性的n.负数;(摄影)底片\r\n
neglect	/ni'ɡlekt/	v./n.忽视;疏忽,漏做,忽略\r\n
negligible	/'neɡlidʒəbl/	a.可忽略不计的,微不足道的\r\n
negotiate	/ni'ɡəuʃieit,-si-/	v.商订;谈判,洽谈,交涉\r\n
Negro	/ˈniːɡroʊ/	n.黑人a.黑人的\r\n
neighbor	/'neibə/	n.(neighbour)邻居\r\n
neighborhood	/'neibəhud/	n.(neighbourhood)邻居;四邻,街道\r\n
neither	/'naiðə,'ni:-/	a.两者都不pron.两者都不ad.也不\r\n
nephew	/'nefju:,'nev-/	n.侄子,外甥\r\n
nerve	/nə:v/	n.神经;勇敢,胆量\r\n
nervous	/'nə:vəs/	a.神经的;神经过敏的,紧张不安的\r\n
nest	/nest/	n.窝,巢v.筑巢\r\n
net	/net/	n.网,网状物v.用网捕,使落网a.纯净的\r\n
network	/'netwə:k/	n.网状物;广播网,电视网;网络\r\n
neutral	/'nju:trəl/	a.中立的;中性的,中和的\r\n
never	/'nevə/	ad.永不,从不,决不;从来没有;不,没有\r\n
nevertheless	/,nevəðə'les/	conj.(nonetheless)然而,不过ad.仍然,不过\r\n
new	/nju:,nu:/	a.新(近)的;新来的;不熟悉的;没经验的\r\n
news	/nju:z,nu:z/	n.新闻,消息;新闻报道,新闻广播\r\n
newspaper	/'nju:s,peipə,'nju:z-/	n.报纸\r\n
next	/nekst/	a.紧接的,其次的;贴近的ad.其次;居后\r\n
nice	/nais/	a.美好的,令人愉快的;友好的,亲切的\r\n
nickel	/'nikəl/	n.镍;镍币;五美分\r\n
nickname	/'nikneim/	n.绰号,浑名vt.给…起绰号\r\n
niece	/ni:s/	n.侄女,甥女\r\n
night	/nait/	n.夜间;夜;晚(上)\r\n
nightmare	/'naitmεə/	n.恶梦;可怕的事物,无法摆脱的恐惧\r\n
nine	/nain/	num.九pron./ad.九(个,只...)\r\n
nineteen	/,nain'ti:n/	num./a.十九pron.十九(个,只...)\r\n
ninety	/'nainti/	num.九十,九十个\r\n
nitrogen	/'naitrədʒən/	n./化/氮\r\n
no	/nəu/	ad.不是,不a.没有的;不允许n.不,拒绝\r\n
noble	/'nəubl/	a.高尚的;贵族的,高贵的n.贵族\r\n
nobody	/'nəubədi,-bɔdi/	pron.谁也不,无人n.小人物\r\n
nod	/nɔd/	v.点(头),点头招呼n.点头招呼;打盹,瞌睡\r\n
noise	/nɔiz/	n.喧闹声,噪声,吵嚷声\r\n
noisy	/'nɔizi/	a.吵闹的,喧闹的\r\n
nominal	/'nɔminəl/	a.名义上的;(金额,租金)微不足道的\r\n
nominate	/'nɔmineit/	v.提名,任命\r\n
none	/nʌn/	pron.没有任何人(东西);都不ad.一点也不\r\n
nonetheless	/ˌnʌnðəˈles/	ad.虽然如此,但是\r\n
nonsense	/'nɔnsəns/	n.胡说,废话\r\n
noodle	/'nu:dl/	n.(常用复数)面条\r\n
noon	/nu:n/	n.中午,正午\r\n
nor	/nɔ:,弱nə/	conj.／ad.也不,也没有\r\n
norm	/nɔ:m/	n.准则,规范,准则,平均数\r\n
normal	/'nɔ:məl/	a.正常的,普通的;正规的,标准的\r\n
normalization	/,nɔ:məlai'zeiʃən/	n.(normalisation)正常化,标准化\r\n
north	/nɔ:θ/	n.北,北方a.北方的,北部ad.向北方,在北方\r\n
northeast	/,nɔ:θ'i:st/	n.东北a.东北方的ad.向东北,在东北\r\n
northern	/ˈnɔːrðərn/	a.北方的,北部的\r\n
northwest	/,nɔ:θ'west/	n.西北方,西北部a.西北的ad.向西北,在西北\r\n
nose	/nəuz/	n.鼻子;(飞机,船等的)前端,突出部分\r\n
not	/nɔt/	ad.不,不是,不会;没有\r\n
notable	/'nəutəbl/	n.值得注意的,显著的,著名的\r\n
note	/nəut/	n.笔记;按语,注释;钞票,纸币v.记下,摘下\r\n
notebook	/'nəutbuk/	n.笔记本\r\n
nothing	/'nʌθiŋ/	n.没有东西;什么也没有;无关紧要的人或事\r\n
notice	/'nəutis/	n.通知,通告,布告;注意,认识v.注意到,注意\r\n
noticeable	/'nəutisəbl/	a.显而易见的,值得注意的,重要的\r\n
notify	/'nəutifai/	v.通知,告知,报告\r\n
notion	/'nəuʃən/	n.概念,想法,意念,看法,观点\r\n
notorious	/nəu'tɔ:riəs/	a.臭名昭著的,声名狼藉的\r\n
notwithstanding	/,nɔtwiθ'stændiŋ/	prep./ad./conj.尽管\r\n
noun	/naun/	n.名词\r\n
nourish	/'nʌriʃ,'nə:-/	v.提供养分,养育,怀有(希望,仇恨等)\r\n
novel	/'nɔvəl/	n.(长篇)小说a.新奇的,新颖的\r\n
novelty	/'nɔvəlti/	n.新奇,新颖,新奇的事物\r\n
November	/noʊˈvembər/	n.十一月\r\n
now	/nau/	ad.现在,如今,目前;当时,于是,然后\r\n
nowadays	/'nauədeiz/	ad.现今,现在\r\n
nowhere	/'nəuhwεə/	ad.任何地方都不,没有地方\r\n
nuclear	/'nju:kliə,'nu:-/	a.核心的,中心的;原子核的,核能的\r\n
nucleus	/'nju:kliəs/	n.(pl.nuclei)核,核心,原子核\r\n
nuisance	/'nju:səns/	n.讨厌的人(或东西);麻烦事\r\n
numb	/nʌm/	a.麻木的,失去感觉的v.使麻木\r\n
number	/'nʌmbə/	n.数,数字,数量,号码,一群v.共计,编号\r\n
numerical	/nju:'merikəl/	a.数字的,用数字表示的,数值的\r\n
numerous	/'nju:mərəs/	a.众多的,许多的,大批的\r\n
nurse	/nə:s/	n.护士,保姆v.护理,看护\r\n
nursery	/'nə:səri/	n.托儿所\r\n
nurture	/'nə:tʃə/	n./v.养育,教育,教养n.营养品v.给与营养物\r\n
nut	/nʌt/	n.坚果;螺母,螺帽\r\n
nutrition	/nju:'triʃən/	n.营养,营养学\r\n
nylon	/'nailɔn/	n.尼龙\r\n
oak	/əuk/	n.橡树,橡木a.橡木的\r\n
oar	/ɔ:,əu/	n.桨,橹v.划,划动,划行\r\n
oath	/əuθ/	n.誓言,誓约,诅咒\r\n
obedience	/əu'bi:diəns/	n.服从,顺从\r\n
obedient	/əu'bi:diənt/	a.服从的,顺从的\r\n
obey	/əu'bei/	v.服从,顺从\r\n
object	/'ɔbdʒikt/	n.物体;客体,对象;目标;宾语v.(to)反对\r\n
objection	/əb'dʒekʃən,ɔb-/	n.(to)反对,异议,不喜欢,反对的理由\r\n
objective	/əb'dʒektiv,ɔb-/	n.目标,目的a.客观的,真实的\r\n
obligation	/,ɔbli'ɡeiʃən/	n.义务,责任\r\n
oblige	/ə'blaidʒ/	v.强迫,迫使;责成;(使)感激,施恩于\r\n
obscure	/əb'skjuə,ɔb-/	a.暗的,朦胧的;模糊的,晦涩的\r\n
observation	/,ɔbzə:'veiʃən/	n.观察,观测,监视;(pl.)观察资料;观察力\r\n
observe	/əb'zə:v/	v.观察,观测,注意到,监视,遵守,评述,说\r\n
obsession	/əb'seʃən,ɔb-/	n.迷住,困扰\r\n
obsolete	/'ɔbsəli:t,,ɔbsə'li:t/	a.已废弃的,过时的\r\n
obstacle	/'ɔbstəkl/	n.障碍(物),妨碍,阻碍,干扰\r\n
obstruct	/əb'strʌkt,ɔb-/	v.阻隔,阻塞(道路、通道等)n.阻碍物,障碍物\r\n
obstruction	/əb'strʌkʃən,ɔb-/	n.妨碍,障碍物\r\n
obtain	/əb'tein,ɔb-/	v.获得,得到\r\n
obvious	/'ɔbviəs/	a.明显的,显而易见的\r\n
occasion	/ə'keiʒən,əu-/	n.场合,时节,时刻;时机,机会\r\n
occasional	/ə'keiʒənəl,əu-/	a.偶然的,非经常的,特殊场合的;临时的\r\n
occupation	/,ɔkju'peiʃən/	n.占领,占据;占用;职业,工作\r\n
occupy	/'ɔkjupai/	v.占,占用;占据,占领;使忙碌,使从事\r\n
occur	/ə'kə:/	v.发生,出现;存在;想起,想到\r\n
occurrence	/ə'kə:rəns,-'kʌ-/	n.发生,出现;事件,事故,发生的事情\r\n
ocean	/'əuʃən/	n.海洋\r\n
o'clock	/ə'klɔk,əu-/	ad.(…)点钟(与1至12数字连用)\r\n
October	/ɑːkˈtoʊbər/	n.十月\r\n
odd	/ɔd/	a.奇数的;奇怪的;单只的;临时的;带零头的\r\n
odds	/ɔdz/	n.不平等,差异;机会\r\n
odor	/'əudə/	n.(odour)气味,香味,臭味,名声\r\n
of	/ɔv,əv,v,f/	prep.…的;在…之中;用…制的;关于…的\r\n
off	/ɔ:f,ɔf/	ad.离开;在远处;脱开prep.从,从...离开\r\n
offend	/ə'fend/	v.犯罪,冒犯,违反,得罪,使...不愉快\r\n
offensive	/ə'fensiv/	a.冒犯的,攻击的n.攻势,进攻\r\n
offer	/'ɔfə,'ɔ:-/	v.提供,提议,出现n.出价,提议,意图\r\n
office	/'ɔfis,'ɔ:-/	n.办公室,办事处;职务,公职;部,局,处\r\n
officer	/'ɔfisə,'ɔ:-/	n.官员,办事员;工作人员;军官\r\n
official	/ə'fiʃəl,əu-/	n.官员,行政官员a.官方的,官方的,正式的\r\n
offset	/,ɔf'set,'ɔfset,'ɔ:-/	n.分支,补偿v.抵消,补偿\r\n
offspring	/'ɔfspriŋ,'ɔ:-/	n.子孙,后代;结果,产物\r\n
often	/'ɔfən,'ɔftən,'ɔ:-/	ad.常常,经常,通常\r\n
oil	/ɔil/	n.油,石油v.给…加润滑油;涂油,上油\r\n
okay	/,o'kɛi/	a.(okey,OK,O.K.)好,行,不错n.同意\r\n
old	/əuld/	a.年老的;…岁的;长时间的,老的;过去的\r\n
omit	/əu'mit/	v.省略,删去;遗漏,忽略\r\n
on	/ɔn,ɔ:n,ən,n/	a.连接上prep.在…上;靠近ad.向前,继续\r\n
once	/wʌns/	ad.一次,曾经conj.一(旦)…就…n.一次\r\n
one	/wʌn/	num.一pron.一个(只)(表示代替可数的东西)\r\n
oneself	/wʌn'self,-zelf/	pron./反身代词/自己;亲自,本人\r\n
onion	/'ʌnjən/	n.洋葱\r\n
only	/'əunli/	ad.仅仅,只不过a.唯一的conj.可是,不过\r\n
onto	/'ɔntu,-tə/	prep.在...上面;到...上面\r\n
opaque	/əu'peik/	a.不透明(光)的;难理解的,晦涩的\r\n
open	/'əupən/	n.公开,户外a.开的,开放的v.开\r\n
opening	/'əupəniŋ/	n.开,开放,开始,空缺,机会a.开始的,开幕的\r\n
opera	/'ɔpərə/	n.歌剧\r\n
operate	/'ɔpəreit/	v.操作,运转,开动,起作用,动手术\r\n
operation	/,ɔpə'reiʃən/	n.运转,开动,操作,手术,运算,经营\r\n
operational	/,ɔpə'reiʃənəl/	a.操作的,运转的,起作用的,经营的\r\n
operator	/'ɔpəreitə/	n.操作人员,(电话)接线员\r\n
opinion	/ə'pinjən/	n.意见,看法,主张\r\n
opponent	/ə'pəunənt/	n.对手,反对者,敌手a.对立的,对抗的\r\n
opportunity	/,ɔpə'tju:niti/	n.机会\r\n
oppose	/ə'pəuz/	v.反对,使对立,使对抗,使相对\r\n
opposite	/'ɔpəzit,-sit/	a.对面的,相对的,相反的n.对立面\r\n
oppress	/ə'pres/	v.压迫,压制\r\n
opt	/ɔpt/	vi.抉择,选择\r\n
optical	/'ɔptikəl/	a.眼的,视力的;光学的\r\n
optimistic	/,ɔpti'mistik/	a.乐观主义的\r\n
optimum	/'ɔptiməm/	a.最适宜的n.最适宜(条件)\r\n
option	/'ɔpʃən/	n.选择(权),/商/选择买卖的特权\r\n
optional	/'ɔpʃənəl/	a.可以任选的,随意的,非强制的\r\n
or	/ɔ:,ə/	conj.或,或者(表示选择);即,大约;否则\r\n
oral	/'ɔ:rəl,'ɔ-/	a.口头的\r\n
orange	/'ɔrindʒ,'ɔ:-/	n.柑,桔,橙\r\n
orbit	/'ɔ:bit/	n.轨道v.(使)沿轨道行\r\n
orchard	/'ɔ:tʃəd/	n.果园,果园里的全部果树,<美俚>棒球场\r\n
orchestra	/'ɔ:kistrə,-kes-/	n.管弦乐队\r\n
order	/'ɔ:də/	n.命令;次序;整齐;定货单;等级v.定制,订购\r\n
orderly	/'ɔ:dəli/	a.整齐的,有秩序的,有条理的n.勤务兵\r\n
ordinary	/'ɔ:dinəri,-neri-/	a.普通的,平凡的,平常的;平庸的\r\n
ore	/ɔ:/	n.矿石,矿砂\r\n
organ	/'ɔ:ɡən/	n.器官;机构,机关;风琴\r\n
organic	/ɔ:'ɡænik/	a.器官的;有机的;有机体的\r\n
organism	/'ɔ:ɡənizəm/	n.生物,有机体\r\n
organization	/,ɔ:ɡənai'zeiʃən,-ni'z-/	n.(organization)组织,团体,机构\r\n
organize	/'ɔ:ɡənaiz/	v.(organise)组织,编组\r\n
orient	/'ɔ:riənt,'əu-,'ɔ:rient/	n.东方,亚洲v.使朝东,为…定位,使适应\r\n
oriental	/ˌɔːriˈentl/	a.东方的,东方诸国的n.东方人\r\n
orientation	/,ɔ:rien'teiʃən,əu-/	n.方向,方位,定位,倾向性,向东方\r\n
origin	/'ɔridʒin,'ɔ:-/	n.起源,由来;出身,来历\r\n
original	/ə'ridʒənəl/	a.最初的,原文的;新颖的n.原物,原作,原文\r\n
originate	/ə'ridʒəneit/	v.(in,from)起源,发生;首创,创造\r\n
ornament	/'ɔ:nəmənt,'ɔ:nəment/	v.装饰,美化n.装饰,装饰物\r\n
orphan	/'ɔ:fən/	n.孤儿\r\n
orthodox	/'ɔ:θədɔks/	a.传统的,正统的,习惯的,保守的,东正教的\r\n
other	/'ʌðə/	a.另外的,其他的n./pron.另一个人(或事)\r\n
otherwise	/'ʌðəwaiz/	ad.另样,用别的方法;在其他方面conj.要不然\r\n
ought	/ɔ:t/	aux.应该(使用时,之后应接to,再接动词原形)\r\n
ounce	/auns/	n.盎司,英两\r\n
our	/'auə,ɑ:/	pron./we的所有格/我们的\r\n
ours	/'auəz,弱ɑ:z/	pron./we的物主代词/我们的(所有物)\r\n
ourselves	/,auə'selvz,,ɑ:-/	pron./反身代词/我们自己;我们亲自\r\n
out	/aut/	ad.出去;离家;突出来a.外面的,往外去的\r\n
outbreak	/'autbreik,,aut'breik/	n.(战争,愤怒,火灾等的)爆发,(疾病的)发作\r\n
outcome	/'autkʌm/	n.结果,成果\r\n
outdoor	/'əutdɔ:/	a.室外的,野外的\r\n
outer	/'autə/	a.外部的,外面的,外层的\r\n
outfit	/'autfit/	n.用具,机构,全套装配v.配备,(得到)装备\r\n
outing	/'autiŋ/	n.外出,旅行,散步\r\n
outlet	/'autlet,-lit/	n.出路,出口;销路,市场;发泄方法;电源插座\r\n
outline	/'autlain/	n.轮廓,略图;大纲,梗概v.概述,略述\r\n
outlook	/'autluk,,aut'luk/	n.景色,风光;观点,见解;展望,前景\r\n
output	/'autput,,aut'put/	n.产量,输出(量)\r\n
outrage	/'autreidʒ/	n.暴行,侮辱,愤怒v.凌辱,引起…义愤,强奸\r\n
outset	/'autset/	n.开始,开端\r\n
outside	/,aut'said,'aut'said/	ad.向外面n.外部a.外部的prep.在…外\r\n
outskirts	/ˈaʊtskɜːrts/	n.郊区\r\n
outstanding	/,aut'stændiŋ/	a.突出的,显著的,杰出的\r\n
outward	/'autwəd/	a.外面的,公开的,向外的ad.向外,在外n.外表\r\n
oval	/'əuvəl/	a.卵形的,椭圆形的n.卵形,椭圆形\r\n
oven	/'ʌvən/	n.炉,灶,灶箱\r\n
over	/'əuvə/	ad.在上方;遍及地prep.在的上方a.结束的\r\n
overall	/'əuvərɔ:l,,əuvə'rɔ:l/	a.全面的,综合的n.(pl.)(套头)工作服\r\n
overcoat	/'əuvəkəut/	n.外衣,大衣\r\n
overcome	/,əuvə'kʌm/	v.战胜,克服\r\n
overflow	/,əuvə'fləu,'əuvəfləu/	v.(使)外溢,(使)溢出;溢出,流出,漫出\r\n
overhead	/'əuvəhed,,əuvə'hed/	a.在头顶上的;架空的ad.在头顶上\r\n
overhear	/,əuvə'hiə/	v.偶然听到,从旁听到\r\n
overlap	/,əuvə'læp,'əuvəlæp/	v.重叠,与…交叠n.重叠\r\n
overlook	/,əuvə'luk,'əuvəluk/	v.看漏,忽略;俯瞰,眺望;宽容,放任\r\n
overnight	/,əuvə'nait,'əuvənait/	a.通宵的,晚上的ad.在昨夜,一夜工夫,突然\r\n
overpass	/'əuvəpɑ:s,-pæs/	n.过街天桥vt.胜过,通过,忽视\r\n
overseas	/'əuvə'si:z/	a.外国的,海外的ad.在海外\r\n
overtake	/,əuvə'teik/	v.追上,超过,突然降临,压倒\r\n
overthrow	/,əuvə'θrəu/	v./n.推翻,颠覆\r\n
overtime	/'əuvətaim/	a.超时的,加班的ad.加班\r\n
overturn	/,əuvə'tə:n,'əuvətə:n/	n.倾覆,破灭,革命v.打翻,推翻,颠倒,翻倒\r\n
overwhelm	/,əuvə'hwelm/	v.淹没,覆没,压倒,制服,使不知所措\r\n
overwhelming	/,əuvə'hwelmiŋ/	a.势不可挡的,压倒的\r\n
owe	/əu/	v.欠(债等),应向…付出,归功于,得感谢\r\n
owing	/'əuiŋ/	a.欠的,未付的\r\n
owl	/aul/	n.猫头鹰\r\n
own	/əun/	a.(用在所有格后面,加强语气)自己的\r\n
owner	/'əunə/	n.物主,所有者\r\n
ownership	/'əunəʃip/	n.所有(权),所有制\r\n
ox	/ɔks/	n.牛,公牛\r\n
oxide	/ˈɑːksaɪd/	n./化/氧化物\r\n
oxygen	/'ɔksidʒən/	n.氧,氧气\r\n
ozone	/'əuzəun/	n.臭氧;(海岸等的)新鲜空气\r\n
pace	/peis,'peisi/	n.步,步伐,步调,速度v.踱步,用步测\r\n
pack	/pæk/	v.捆扎,打包;塞满,挤满n.包裹,背包,一群/副\r\n
package	/'pækidʒ/	n.包装,包裹,箱,包装费,标准部件,成套设备\r\n
packet	/'pækit/	n.小包裹,小捆;盒;一捆,一扎;邮船,班轮\r\n
pact	/pækt/	n.合同,条约,公约,协定\r\n
pad	/pæd/	n.垫,衬垫;便笺簿v.加上衬垫\r\n
paddle	/'pædl/	n.桨v.用桨划\r\n
page	/peidʒ/	n.页,记录,事件,专栏vt.给...标页码\r\n
pail	/peil/	n.桶,提桶;一桶的量\r\n
pain	/pein/	n.痛,痛苦;(pl.)努力,劳苦vt.使痛苦\r\n
painful	/'peinfl/	a.疼痛的,使痛苦的,费力/心/的,棘手的\r\n
paint	/peint/	n.油漆,颜料v.油漆;涂,涂漆;画;描绘,描述\r\n
painter	/'peintə/	n.漆工,画家\r\n
painting	/'peintiŋ/	n.上油漆,着色;绘画;油画;画法\r\n
pair	/pεə/	n.一对,一双;一副;夫妇v.配对,成对\r\n
palace	/'pælis/	n.宫,宫殿\r\n
pale	/peil/	a.苍白的,灰白的;浅的,暗淡的\r\n
palm	/pɑ:m/	n.手掌,掌状物,棕榈vt.与…握手,藏…于掌中\r\n
pamphlet	/'pæmflit/	n.小册子\r\n
pan	/pæn/	n.平底锅,盘子,面板\r\n
panda	/'pændə/	n.熊猫\r\n
panel	/'pænl/	n.面,板;控制板,仪表盘;专门小组\r\n
panic	/'pænik/	n./a.恐慌(的),惊慌(的)vt.使惊慌,使害怕\r\n
panorama	/,pænə'rɑ:mə/	n.全景,全景画,全景摄影,全景照片/装置/\r\n
pant	/pænt/	n.喘气v.喘,气喘吁吁地说\r\n
pants	/pænts/	n.裤子,短裤\r\n
paper	/'peipə/	n.纸;纸制品;报纸;(pl)文件;试卷;论文\r\n
paperback	/'peipəbæk/	n.平装本,简装本\r\n
parachute	/'pærə,ʃu:t/	n.降落伞v.跳伞\r\n
parade	/pə'reid/	n./v.游行,夸耀n.检阅,阅兵式v.使列队行进\r\n
paradigm	/'pærədim/	n.典范;范例;示例\r\n
paradox	/'pærədɔks/	n.似非而是的话,自相矛盾的话,反论\r\n
paragraph	/'pærəɡrɑ:f,-ɡræf/	n.段,节;小新闻,短评\r\n
parallel	/'pærəlel/	a.平行的,相同的,类似的n.平行线,类似,对比\r\n
paralyze	/'pærəlaiz/	v.(paralyse)使瘫痪(麻痹);使丧失作用\r\n
parameter	/pə'ræmitə/	n.参数,参量\r\n
parasite	/'pærəsait/	n.寄生虫,食客\r\n
parcel	/'pɑ:sl/	n.包裹,邮包,部分v.打包,捆扎,分配\r\n
pardon	/'pɑ:dn/	n.原谅,宽恕;请再说一遍v.原谅,饶恕,赦免\r\n
parent	/'pεərənt/	n.父母,母亲;(pl.)双亲;父母\r\n
park	/pɑ:k/	n.公园,停车场,运动场v.停放(汽车等),寄放\r\n
parliament	/'pɑ:ləmənt/	n.国会,议会\r\n
part	/pɑ:t/	n.部分,角色,一方,零件,地区,部,篇v.使分开\r\n
partial	/'pɑ:ʃəl/	a.部分的,不完全的;偏袒的,不公平的,偏爱的\r\n
participant	/pɑ:'tisipənt/	n.参加者,参与者a.有份的,参与的\r\n
participate	/pɑ:'tisipeit/	v.(in)参与,参加;分享,分担;含有,带有\r\n
particle	/'pɑ:tikl/	n.粒子,微粒;极小量;小品词,虚词\r\n
particular	/pə'tikjulə/	a.特殊的,苛求的,个别的n.详情,细节,特色\r\n
partly	/'pɑ:tli/	ad.部分地,不完全地,在一定程度上\r\n
partner	/'pɑ:tnə/	n.合作者,合伙人,合股人,伙伴,舞伴,配偶\r\n
party	/'pɑ:ti/	n.聚会,政党,当事人v.举行(参加)社交聚会\r\n
pass	/pɑ:s,pæs/	v.经/通/穿/度过;传递n.通行证;考试及格\r\n
passage	/'pəsidʒ/	n.通过,经过;通路,走廊;(一)段落,(一)节\r\n
passenger	/'pæsindʒə/	n.乘客,旅客\r\n
passer-by	/ˌpɑːsə ˈbaɪ/	n.(pl.passers-by)过路人\r\n
passion	/'pæʃən/	n.热情,激情,爱好;激怒;强烈感情\r\n
passive	/'pæsiv/	a.被动的,消极的\r\n
passport	/'pɑ:spɔ:t,'pæs-/	n.护照,达到某种目的的手段\r\n
past	/pɑ:st,pæst/	a.过去的ad.过n.过去,昔日prep.(经)过\r\n
paste	/peist/	n.糊,浆糊v.粘,贴\r\n
pastime	/'pɑ:staim/	n.消遣,娱乐\r\n
pasture	/'pɑ:stʃə,'pæs-/	n.牧草地,牧场\r\n
pat	/pæt/	v./n.轻拍,轻打,抚摸\r\n
patch	/pætʃ/	n.补丁,斑点,碎片小块v.补,修补,掩饰\r\n
patent	/'peitənt/	a.专利的,特许的n.专利(权、品)v.批准专利\r\n
path	/pɑ:θ,pæθ/	n.小路,小径;路线,轨道\r\n
pathetic	/pə'θetik/	a.可怜的,悲惨的\r\n
patience	/'peiʃəns/	n.耐心,忍耐\r\n
patient	/'peiʃənt/	a.有耐心的,能忍耐的n.病人,患者\r\n
patriotic	/,pætri'ɔtik/	a.爱国的\r\n
patrol	/pə'trəul/	v.巡逻,巡查n.巡逻,巡查;巡逻队\r\n
patron	/'peitrən/	n.赞助人;资助人;老顾客,老主顾\r\n
pattern	/'pætən/	n.模式,式样;图案,图样v.仿制,模仿\r\n
pause	/pɔ:z/	v./n.中止,暂停\r\n
pave	/peiv/	v.铺砌,铺(路)\r\n
pavement	/'peivmənt/	n.人行道\r\n
paw	/pɔ:/	n.爪\r\n
pay	/pei/	v.付款,付出代价,给予注意n.工资,薪金\r\n
payment	/'peimənt/	n.支付,付款额\r\n
pea	/pi:/	n.豌豆\r\n
peace	/pi:s/	n.和平;平静,安宁\r\n
peaceful	/'pi:sful/	a.和平的,平静的,安宁的,爱好和平的\r\n
peach	/pi:tʃ/	n.桃,桃树\r\n
peak	/pi:k/	n.山顶,最高点;峰,山峰a.高峰的,最高的\r\n
peanut	/'pi:nʌt/	n.花生\r\n
pear	/pεə/	n.梨子,梨树\r\n
pearl	/pə:l/	n.珍珠\r\n
peasant	/'pezənt/	n.(不用于英国或美国)小农;佃农;农民\r\n
pebble	/'pebl/	n.卵石\r\n
peculiar	/pi'kju:ljə/	a.古怪的,异常的;特殊的,特有的\r\n
pedal	/'pedl/	n.踏板v.踩踏板,骑自行车\r\n
pedestrian	/pi'destriən/	n.步行者a.徒步的,呆板的,通俗的\r\n
peel	/pi:l/	v.削皮,剥皮n.果皮\r\n
peep	/pi:p/	v.偷看,窥视\r\n
peer	/piə/	n.同辈,同等地位的人;贵族v.凝视,隐约出现\r\n
pen	/pen/	n.钢笔,圆珠笔,作家,围栏vt.写,关入栏中\r\n
penalty	/'penəlti/	n.处罚,刑罚,惩罚,罚金\r\n
pencil	/'pensəl/	n.铅笔vt.用铅笔写\r\n
pendulum	/'pendjuləm,-dʒə-/	n.摆,钟摆\r\n
penetrate	/'penitreit/	v.穿过,渗入,看穿\r\n
peninsula	/pi'ninsjulə/	n.半岛\r\n
penny	/'peni/	n.便士,美分\r\n
pension	/'penʃən/	n.养老金,抚恤金\r\n
people	/'pi:pl/	n.人们,人;/the-/人民;一国人民,民族\r\n
pepper	/'pepə/	n.胡椒粉,胡椒;辣椒\r\n
per	/强pə:,弱pə/	prep.每;经,由\r\n
perceive	/pə'si:v/	v.察觉,感知;理解,领悟\r\n
percent	/pə'sent/	n.(percent)百分之...的\r\n
percentage	/pə'sentidʒ/	n.百分数,百分率,百分比\r\n
perfect	/'pə:fikt,pə'fekt/	a.完善的;完全的;(语法)完成的v.使完美\r\n
perfection	/pə'fekʃən/	n.尽善尽美,完美\r\n
perform	/pə'fɔ:m/	v.履行,执行;表演,演出;完成(事业)\r\n
performance	/pə'fɔ:məns/	n.履行,执行;表演,演出;性能,特性;成绩\r\n
perfume	/pə'fju:m/	n.香味,芳香;香料v.使发香,洒香水于\r\n
perhaps	/pə'hæps,præps/	ad.也许,大概,恐怕\r\n
period	/'piəriəd/	n.时期,时代;学时;周期,一段时间;句点\r\n
periodical	/,piəri'ɔdikəl/	n.期刊,杂志a.周期的,定期的\r\n
perish	/'periʃ/	v.丧生;凋谢;毁灭,消亡\r\n
permanent	/'pə:mənənt/	a.永久的,持久的\r\n
permeate	/'pə:mieit/	v.弥漫,遍布,散布;渗入,渗透\r\n
permission	/pə'miʃən/	n.允许,同意\r\n
permit	/pə'mit/	v.许可,允许n.许可证,执照\r\n
perpetual	/pə'petʃuəl,-tju-/	a.永久的,永恒的,长期的\r\n
perplex	/pə'pleks/	v.使困惑,使费解,使复杂化\r\n
persecute	/'pə:sikju:t/	v.迫害\r\n
persevere	/,pə:si'viə/	v.坚持,坚忍,不屈不挠\r\n
persist	/pə'sist,-'zist/	v.(in)坚持,持续\r\n
person	/'pə:sən/	n.人,喜欢(或适应)..的人;人物;人称\r\n
personal	/'pə:sənl/	a.个人的,私人的;亲自的;身体的,人身的\r\n
personality	/,pə:sə'næləti/	n.人格,个性\r\n
personnel	/,pə:sə'nel/	n.全体人员,全体职员;人事(部门)\r\n
perspective	/pə'spektiv/	n.透视画法,透视图;远景,前途;观点,看法\r\n
persuade	/pə'sweid/	v.说服,劝说;(of)使相信\r\n
persuasion	/pə'sweiʒən/	n.说服,说服力\r\n
pessimistic	/,pesi'mistik/	a.悲观(主义)的\r\n
pest	/pest/	n.害虫\r\n
pet	/pet/	n.爱畜,宠儿a.宠爱的,表示亲昵的\r\n
petition	/pi'tiʃən/	n.请愿书,申请书v.(向…)请愿,正式请求\r\n
petrol	/'petrəl/	n.汽油\r\n
petroleum	/pi'trəuliəm,pə-/	n.石油\r\n
petty	/'peti/	a.小(器、规模)的,不重要的,细微的,卑鄙的\r\n
pharmacy	/'fɑ:məsi/	n.药房,药剂学,制药业,配药业,一批备用药品\r\n
phase	/feiz/	n.阶段,状态,时期;相,相位\r\n
phenomenon	/fi'nɔminən,fə-/	n.现象,稀有现象,珍品,奇迹,杰出人才\r\n
philosopher	/fi'lɔsəfə,fə-/	n.哲学家,哲人\r\n
philosophy	/fi'lɔsəfi,fə-/	n.哲学,哲理,人生观,价值观,世界观\r\n
phone	/fəun/	n.(telephone)电话,电话机,耳机v.打电话\r\n
photo	/'fəutəu/	n.(photograph)照片\r\n
phrase	/freiz/	n.短语,词语,习语\r\n
physical	/'fizikəl/	a.物质的;肉体的,身体的;自然科学的,物理的\r\n
physician	/fi'ziʃən/	n.内科医生\r\n
physicist	/'fizisist/	n.物理学家\r\n
physics	/'fiziks/	n.物理(学)\r\n
physiological	/,fiziə'lɔdʒikəl/	a.生理学的,生理学上的\r\n
piano	/pi'ænəu,pi'ɑ:-/	n.钢琴\r\n
pick	/pik/	v.拾,采,摘;挑选,选择n.镐,鹤嘴锄\r\n
pickup	/'pikʌp/	n.拾起,获得\r\n
picnic	/'piknik/	n.野餐v.(去)野餐\r\n
picture	/'piktʃə/	n.画,图片;影片;美景v.画,描述,想象\r\n
pie	/pai/	n.馅饼\r\n
piece	/pi:s/	n.(一)件/片/篇;碎片v.(together)拼合,拼凑\r\n
pierce	/piəs/	v.剌穿,刺破\r\n
pig	/piɡ/	n.猪,猪肉;猪一般的人(指肮脏,贪吃的人)\r\n
pigeon	/'pidʒin/	n.鸽\r\n
pile	/pail/	n.堆,大量,大数目v.(up)堆,叠,堆积\r\n
pilgrim	/'pilɡrim/	n.(在国外)旅游者;朝圣者,最初的移民\r\n
pill	/pil/	n.药丸\r\n
pillar	/'pilə/	n.柱,台柱,栋梁\r\n
pillow	/'piləu/	n.枕头\r\n
pilot	/'pailət/	n.飞行员;领港员v.驾驶(飞机等);领航,引水\r\n
pin	/pin/	n.钉;大头针,别针,徽章v.(up)钉住,别住\r\n
pinch	/pintʃ/	v.捏,掐,拧;收缩;紧急关头;匮乏;压力\r\n
pine	/pain/	n.松树\r\n
pink	/piŋk/	n.粉红色a.粉红色的\r\n
pint	/paint/	n.品脱\r\n
pioneer	/,paiə'niə/	n.先驱,倡导者,开拓者\r\n
pipe	/paip/	n.管子,导管;烟斗;笛\r\n
pirate	/'paiərit/	n./v.海盗,盗版(者)\r\n
pistol	/'pistl/	n.手枪\r\n
piston	/'pistən/	n.活塞\r\n
pit	/pit/	n.坑,陷阱;煤矿,矿井\r\n
pitch	/pitʃ/	n.沥青;掷v.用沥青覆盖;投掷,扔\r\n
pity	/'piti/	v.(觉得)可怜,惋惜n.憾事,怜悯\r\n
place	/pleis/	n.地方;名次;地位;寓所v.安排;放置;投(资)\r\n
plague	/pleiɡ/	n.瘟疫,灾害,麻烦,苦恼vt.折磨,使苦恼\r\n
plain	/plein/	a.明白的;朴素的;坦率;平凡n.平原,旷野\r\n
plan	/plæn/	n.计划,规划;平面图,设计图v.计划\r\n
plane	/plein/	n.飞机;平面,水平面\r\n
planet	/'plænit/	n.行星\r\n
plant	/plɑ:nt,plænt/	n.植物,作物;工厂;装置v.栽种,播种,栽培\r\n
plantation	/plæn'teiʃən/	n.种植园\r\n
plaster	/'plɑ:stə,'plæs-/	n.灰泥;熟石膏;膏药\r\n
plastic	/'plæstik,'plɑ:s-/	n.(常pl.)塑料,塑料制品a.可塑的,塑性的\r\n
plate	/pleit/	n.金属板,片;盘子,盆子;板,钢板v.镀,电镀\r\n
plateau	/'plætəu,plæ't-/	n.高原,平稳状态/时期/\r\n
platform	/'plætfɔ:m/	n.平台,台;站台,月台;政纲,党纲\r\n
plausible	/'plɔ:zəble/	a.似是而非的,似乎合理的,似乎可信的\r\n
play	/plei/	v.玩,做游戏;参加比赛n.游戏;玩耍;剧本\r\n
playground	/'pleiɡraund/	n.运动场,游戏场\r\n
plea	/pli:/	n.(法律)抗辩;请求,恳求,托词,口实\r\n
plead	/pli:d/	v.恳求,请求;为…辩护;提出…为理由\r\n
pleasant	/'plezənt/	a.令人愉快的vt.使高兴vi.满意;喜欢\r\n
please	/pli:z/	v.请;使愉快,使满意;喜欢,愿意\r\n
pleasure	/'pleʒə,'plei-/	n.愉快,快乐;乐事,乐趣\r\n
pledge	/pledʒ/	n.誓约;保证v.发誓;保证\r\n
plentiful	/'plentiful/	a.富裕的,丰富的\r\n
plenty	/'plenti/	n.丰富,大量\r\n
plight	/plait/	n.情况,状态,困境,盟誓(婚姻)v.保证,约定\r\n
plot	/plɔt/	n.秘密计划;情节v.标绘,绘制;密谋,策划\r\n
plough	/plau/	n.(plow)犁,耕地,犁过的地v.犁,费力地前进\r\n
plug	/plʌɡ/	n.塞子,插头v.堵,塞,插上,插栓\r\n
plumber	/'plʌmə/	n.(装修水管的)管子工\r\n
plunge	/plʌndʒ/	v.(into)(使)投入,(使)插进,陷入;猛冲\r\n
plural	/'pluərəl/	a.复数的n.复数\r\n
plus	/plʌs/	prep.加上a.正的,加的n.加号,正号\r\n
pneumonia	/nju:'məunjə/	n.肺炎\r\n
pocket	/'pɔkit/	n.衣袋a.袖珍的,小型的v.把…装入袋内\r\n
poem	/'pəuim/	n.诗\r\n
poet	/'pəuit/	n.诗人\r\n
poetry	/'pəuitri/	n.诗歌,诗集\r\n
point	/pɔint/	n.尖;点;条款;分数,得分;论点v.(at,to)指\r\n
poison	/'pɔizən/	n.毒物,毒药v.放毒,毒害,污染\r\n
poisonous	/'pɔizənəs/	a.有毒的,恶意的,恶毒的,道德败坏的\r\n
poke	/pəuk/	n.刺,戳,懒汉,袋子v.戳,刺,伸出,刺探,闲荡\r\n
polar	/'pəulə/	a.两极的,极地的,南辕北辙的n.极线,极面\r\n
pole	/pəul/	n.柱,杆;地极,磁极,电极\r\n
police	/pə'li:s/	n.警察,警察机关a.警察的v.管辖\r\n
policeman	/pə'li:smən/	n.警察\r\n
policy	/'pɔlisi/	n.政策,方针\r\n
polish	/'pɔliʃ/	v.磨光,擦亮;使优美,润饰n.擦光剂,上光蜡\r\n
polite	/'pə:lait/	a.有礼貌的,客气的;有教养的,文雅的\r\n
political	/pə'litikəl/	a.政治的\r\n
politician	/,pɔli'tiʃən/	n.政治家,政客\r\n
politics	/'pɔlitiks/	n.政治,政治学;政纲,政见\r\n
poll	/pəul/	n.民意测验;(pl.)政治选举v.获得…选票\r\n
pollute	/pə'lju:t/	v.弄脏,污染\r\n
pollution	/pə:'lju:ʃən/	n.污染\r\n
pond	/pɔnd/	n.池塘\r\n
ponder	/'pɔndə/	v.沉思,考虑\r\n
pool	/pu:l/	n.水池,游泳池;合资经营v.合伙经营,联营\r\n
poor	/puə,pɔ:/	a.贫困的;可怜的;贫乏的;贫瘠的;低劣的\r\n
pop	/pɔp/	a.流行的n.(发出)砰的一声v.突然出现\r\n
pope	/pəup/	n.罗马教皇,主教,大腿上要害部位\r\n
popular	/'pɔpjulə/	a.流行的,通俗的,大众的;广受欢迎的\r\n
population	/,pɔpju'leiʃən/	n.人口,(全体)居民\r\n
porcelain	/'pɔ:səlin,-lein/	n.瓷器a.精制的,瓷器的\r\n
porch	/pɔ:tʃ/	n.门廊,入口处\r\n
pork	/pɔ:k/	n.猪肉\r\n
port	/pɔ:t,pəut/	n.港口\r\n
portable	/'pɔ:təbl,'pəu-/	a.轻便的,手提(式)的,可移动的\r\n
porter	/'pɔ:tə,'pəu-/	n.守门人,门房,行李搬运工,服务员\r\n
portion	/'pɔ:ʃən,'pəu-/	n.一部分,一份\r\n
portrait	/'pɔ:trit,-treit,'pəu-/	n.肖像,画像\r\n
portray	/pɔ:'trei,pəu-/	v.描写,描述;画(人物、景象等)\r\n
pose	/pəuz/	n.姿势,姿态v.造成,提出,摆姿势,佯装\r\n
position	/pə'ziʃən/	n.位置;职位;姿势,姿态;见解,立场,形势\r\n
positive	/'pɔzətiv,-zi-/	a.肯定的,积极的,绝对的,无疑的,正的\r\n
possess	/pə'zes/	v.占有,拥有\r\n
possession	/pə'zeʃən/	n.持有,拥有;所有权;所有物;(pl.)财产,财富\r\n
possibility	/,pɔsə'biləti/	n.可能,可能性;可能的事,希望\r\n
possible	/'pɔsəbl/	a.可能的,做得到的;合理的;可允许的\r\n
possibly	/'pɔsəbli/	ad.可能地,也许;无论如何\r\n
post	/pəust/	v.贴出;公告;投寄n.(支)柱;邮政,邮寄;职位\r\n
postage	/'pəustidʒ/	n.邮费,邮资\r\n
postcard	/ˈpəʊstkɑːd/	n.明信片\r\n
poster	/'pəustə/	n海报,张贴的大幅广告\r\n
postman	/'pəustmən/	n.邮递员\r\n
postpone	/pəust'pəun,pə'sp-/	v.推迟,延期\r\n
posture	/'pɔstʃə/	n.姿势,姿态,心态,态度v.作出某种姿势\r\n
pot	/pɔt/	n.罐,壶\r\n
potato	/pə'teitəu/	n.马铃薯,土豆\r\n
potential	/pəu'tenʃəl/	a.潜在的,可能的n.潜能,潜力\r\n
poultry	/'pəultri/	n.家禽\r\n
pound	/paund/	n.磅;英镑v.(连续)猛击,(猛烈)敲打,捣碎\r\n
pour	/pɔ:/	v.灌注,倾泻,涌入,流,倾盆大雨\r\n
poverty	/'pɔvəti/	n.贫穷,贫困\r\n
powder	/'paudə/	n.粉末,药粉;火药,炸药\r\n
power	/pauə/	n.力,精力;功率,电力;(数学)幂;权力,势力\r\n
powerful	/'pauəful/	a.强大的,有力的,有权的\r\n
practical	/'præktikəl/	a.实际的,实用的\r\n
practically	/'præktikəli/	ad.几乎,实际上,简直\r\n
practice	/'præktis/	n.练习,实践,实际,业务,惯例,习惯\r\n
practise	/'præktis/	v.练习,实习,实践,实行,使...练习,训练\r\n
practitioner	/præk'tiʃənə/	n.实践者,从事者;(医生或律师等)开业者\r\n
praise	/preiz/	v.赞扬,歌颂;表扬n.称赞,赞美;赞美的话\r\n
pray	/prei/	v.请求,恳求;祈祷,祈求\r\n
prayer	/preə/	n.祈祷,祷告,祷文\r\n
preach	/pri:tʃ/	v.宣讲(教义),布道;竭力鼓吹,宣传;说教\r\n
precaution	/pri'kɔ:ʃən/	n.预防,谨慎,警惕\r\n
precede	/pri:'si:d,pri-/	v.领先(于),在(…之前);优先,先于\r\n
precedent	/pri'si:dənt,'presi-/	n.先例\r\n
preceding	/pri'si:diŋ,'pri:-/	a.在前的,在先的\r\n
precious	/'preʃəs/	a.珍贵的,贵重的\r\n
precise	/pri'sais/	a.精确的,准确的\r\n
precision	/pri'siʒən/	n.精确,精确度\r\n
preclude	/pri'klu:d/	v.排除,阻止,妨碍\r\n
predecessor	/'pri:disesə,'pre-/	n.前辈,前任\r\n
predict	/pri'dikt/	v.预言,预测,预告\r\n
predominant	/,pri'dɔminənt/	a.(over)占优势的;主要的,突出的\r\n
preface	/'prefis/	n.序言,引言,前言v.作序,写前言\r\n
prefer	/pri'fə:/	v.(to)更喜欢,宁愿\r\n
preferable	/'prefərəbl/	a.(to)更可取的,更好的\r\n
preference	/'prefərəns/	n.(for,to)偏爱,喜爱;优惠;优先选择\r\n
pregnant	/'preɡnənt/	a.怀孕的,孕育的,充满的,意味深长的\r\n
prejudice	/'predʒudis/	n.偏见,成见;损害,侵害v.使抱偏见,损害\r\n
preliminary	/pri'liminəri/	a.预备的,初步的\r\n
premier	/'premjə,pri'miə/	n.首相,总理\r\n
premise	/pri'maiz,'premis/	n.前提,房屋连地基v.提论,预述,假定\r\n
premium	/'pri:miəm/	n.额外费用,奖金,奖赏,保险费\r\n
preparation	/,prepə'reiʃən/	n.准备,预备;制剂,制备品\r\n
prepare	/pri'pεə/	v.准备,预备\r\n
preposition	/,prepə'ziʃən/	n.介词\r\n
prescribe	/pris'kraib/	v.指示,规定;处(方),开(药)\r\n
prescription	/pris'kripʃən/	n.药方,处方\r\n
presence	/'prezəns/	n.出席,到场,存在,在\r\n
present	/'prezənt,pri'zent/	a.出席的,现在的n.现在,礼物v.赠送,提出\r\n
presently	/'prezəntli/	ad.一会儿,不久;现在,目前\r\n
preserve	/pri'zə:v/	v.保护,维持;保存,保藏\r\n
preside	/pri'zaid/	v.(at,over)主持\r\n
president	/'prezidənt/	n.总统,校长,会长,主席\r\n
press	/pres/	v.压;压榨;紧迫,催促n.报刊,通讯社;压榨机\r\n
pressure	/'preʃə/	n.压,压力,压迫,强制,紧迫,困苦,困难\r\n
prestige	/pre'sti:ʒ/	n.声望,威望,威信\r\n
presumably	/pri'zju:-məbli,pri:-/	ad.推测起来,大概\r\n
presume	/pri'zju:m,-'zu:m/	v.假定,假设,认为,揣测,滥用,擅自行动\r\n
pretend	/pri'tend,pri:-/	v.假装,假托,借口,(在演戏中)装扮\r\n
pretext	/'pri:tekst/	n.借口,托词\r\n
pretty	/'priti/	ad.相当,很a.漂亮的,俊俏的,标致的\r\n
prevail	/pri'veil,pri:-/	v.(over,against)取胜,占优势;流行,盛行\r\n
prevalent	/'prevələnt/	a.流行的,普遍的\r\n
prevent	/pri'vent,pri:-/	v.(from)预防,防止,阻止,制止,妨碍\r\n
previous	/'pri:vjəs/	a.先前的,以前的\r\n
prey	/prei/	n.被掠食者,牺牲者,掠食v.捕食,掠夺,折磨\r\n
price	/prais/	n.价格,价钱;代价v.标价\r\n
prick	/prik/	n./v.刺伤,刺痛,刺孔\r\n
pride	/praid/	n.自豪;自满;引以自豪的东西v.使自豪\r\n
priest	/pri:st/	n.教士,神父\r\n
primary	/'praiməri/	a.最初的,初级的;首要的,主要的,基本的\r\n
prime	/praim/	a.首要的;最好的,第一流的n.青春,全盛期\r\n
primitive	/'primitiv/	a.原始的,远古的,早期的;粗糙的,简单的\r\n
prince	/prins/	n.王子,亲王\r\n
princess	/prin'ses,'prinsis/	n.公主,王妃\r\n
principal	/'prinsəpəl/	a.最重要的,主要的n.负责人,校长;资本,本金\r\n
principle	/'prinsəpl/	n.原理,原则;主义,信念\r\n
print	/print/	n.印刷,印刷品,字体v.印刷,出版;洗印\r\n
prior	/'praiə/	a.优先的,在前的;(to)在…之前\r\n
priority	/prai'ɔrəti/	n.先,前;优先,重点,优先权\r\n
prison	/'prizən/	n.监狱\r\n
prisoner	/'prizənə/	n.囚犯\r\n
privacy	/'praivəsi,'pri-'prai-/	n.(不受干扰的)独处,自由,隐私;私生活\r\n
private	/'praivit/	a.私人的,个人的,秘密的,私下的\r\n
privilege	/'privilidʒ/	n.特权,优惠,特许v.给予优惠,给予特权\r\n
prize	/praiz/	n.奖赏,奖金,奖品v.珍视,珍惜\r\n
probability	/,prɔbə'biləti/	n.可能性,或然性,概率\r\n
probable	/'prɔbəbl/	a.很可能的,大概的;有希望的,可能的\r\n
probe	/prəub/	n.探针,探测器v.(以探针等)探查,穿刺,查究\r\n
problem	/'prɔbləm/	n.问题,疑难问题;思考题,讨论题\r\n
procedure	/prə'si:dʒə/	n.程序,手续,步骤\r\n
proceed	/prəu'si:d/	v.进行,继续下去;发生\r\n
proceeding	/prəu'si:diŋ/	n.行动,进行,(pl.)会议录,学报\r\n
process	/'prəuses,'prɔ-/	n.过程,进程;工序,制作法;工艺v.加工,处理\r\n
procession	/prəu'seʃən/	n.队伍,行列\r\n
proclaim	/prəu'kleim/	v.宣告,声明\r\n
produce	/prəu'dju:s,'prɔdju:s/	v.生产,制造,显示,演出,导致n.产品\r\n
product	/'prɔdəkt,-ʌkt/	n.产品,产物;乘积\r\n
production	/prəu'dʌkʃən/	n.生产,产品,作品,(研究)成果,总产量\r\n
productive	/prəu'dʌktiv/	a.生产(性)的,能产的,多产的\r\n
productivity	/,prɔdʌk'tivəti,,prəu-/	n.生产率\r\n
profession	/prəu'feʃən/	n.职业,专业,表白,宣布\r\n
professional	/prəu'feʃənəl/	a.职业的,专门的n.自由职业者,专业人员\r\n
professor	/prəu'fesə/	n.教授\r\n
proficiency	/prəu'fiʃənsi/	n.(in)熟练,精通\r\n
profile	/'prəufail/	n.侧面(像);轮廓,外形;人物简介\r\n
profit	/'prɔfit/	n.利润,收益v.(by,from)得利,获益;有利于\r\n
profitable	/'prɔfitəbl/	a.有利可图的,有益的\r\n
profound	/prəu'faund/	a.深刻的,意义深远的;渊博的,造诣深的\r\n
programme	/'prəuɡræm,-ɡrəm/	n.(program)节目,计划,规划,程序v.编程序\r\n
progress	/'prəuɡres,prəu'ɡres/	v./n.进步,进展;前进\r\n
progressive	/prəu'ɡresiv/	a.进步的,先进的;前进的\r\n
prohibit	/prəu'hibit/	v.禁止,不准;阻止\r\n
project	/'prɔdʒekt,prə'dʒekt/	n.方案,工程,项目v.投射,放映;设计,规划\r\n
projector	/prəu'dʒektə/	n.放映机,幻灯机,投影仪\r\n
prolong	/prə'lɔŋ,'lɔ:ŋ/	v.拉长,延长,拖延\r\n
prominent	/'prɔminənt/	a.突起的,凸出的;突出的,杰出的\r\n
promise	/'prɔmis/	v.允许,答应;有…可能n.承诺;希望,出息\r\n
promising	/'prɔmisiŋ/	a.有希望的,有前途的\r\n
promote	/prəu'məut/	v.促进,发扬;提升,提拔;增进,助长\r\n
prompt	/prɔmpt/	a.敏捷的,迅速的,即刻的v.激起,促进,推动\r\n
prone	/prəun/	a.倾向于,俯伏的,倾斜的,陡的\r\n
pronoun	/'prəunaun/	n.代词\r\n
pronounce	/prəu'nauns/	v.发…的音;宣布,宣判\r\n
pronunciation	/prəu,nʌnsi'eiʃən/	n.发音,发音方法\r\n
proof	/pru:f/	n.证据,证明;校样,样张\r\n
propaganda	/,prɔpə'ɡændə/	n.宣传(机构);/天主教/传道总会\r\n
propel	/prəu'pel/	vt.推进,推动;激励,驱使\r\n
proper	/'prɔpə/	a.适合的;合乎体统的;固有的;有礼貌的\r\n
property	/'prɔpəti/	n.财产,资产,地产,房地产,所有物;性质,特性\r\n
prophet	/'prɔfit/	n.预言家;先知;提倡者\r\n
proportion	/prəu'pɔ:ʃən/	n.比例;部分;均衡,相称\r\n
proposal	/prəu'pəuzəl/	n.提议,建议;求婚\r\n
propose	/prəu'pəuz/	v.提议,建议;提名,推荐;求婚\r\n
proposition	/,prɔpə'ziʃən/	n.主张,建议;陈述,命题\r\n
prose	/prəuz/	n.散文a.散文的\r\n
prosecute	/'prɔsikju:t/	vt.实行,从事v.起诉,告发vi.作检察官\r\n
prospect	/'prɔspekt/	n.景色;前景,前途,展望\r\n
prospective	/prəu'spektiv/	a.预期的\r\n
prosper	/'prɔspə/	v.成功,兴隆,昌盛,使成功,使昌隆,繁荣\r\n
prosperity	/prɔs'periti/	n.繁荣,兴旺\r\n
prosperous	/'prɔspərəs/	a.繁荣的,兴旺的,茂盛的,顺利的\r\n
protect	/prəu'tekt/	v.(from)保护,保卫\r\n
protein	/'prəuti:n,-ti:in/	n.蛋白质\r\n
protest	/prəu'test,'prəu-/	v./n.主张,断言,抗议,反对\r\n
prototype	/'prəutətaip/	n.原型;典型,范例\r\n
proud	/praud/	a.(of)自豪的;引以自豪的;妄自尊大的\r\n
prove	/pru:v/	v.证明,证实;检验;考验;鉴定;结果是,表明是\r\n
provide	/prəu'vaid/	v.供应,供给,准备,预防,规定\r\n
provided	/prəˈvaɪdɪd/	conj.倘若,只要,假如\r\n
province	/'prɔvins/	n.省;领域,范围,本分\r\n
provision	/prəu'viʒən/	n.供应,(一批)供应品;预备;条款;(pl.)给养\r\n
provoke	/prəu'vəuk/	v.挑动;激发;招惹\r\n
prudent	/'pru:dənt/	a.谨慎的,智慧的,稳健的,节俭的\r\n
psychiatry	/psai'kaiətri,psi-/	n.精神病学,精神病疗法\r\n
psychology	/psai'kɔlədʒi/	n.心理,心理学,心理状态\r\n
pub	/pʌb/	n.(英国)小酒店;小旅馆\r\n
public	/'pʌblik/	a.公共的,公用的;公开的,公然的n.公众,民众\r\n
publication	/,pʌbli'keiʃən/	n.出版物;出版,发行;公布,发表\r\n
publicity	/pʌb'lisiti/	n.公开,宣传,广告,推销\r\n
publish	/'pʌbliʃ/	v.出版,刊印;公布,发布\r\n
puff	/pʌf/	n.一阵,一股(气味等);喘息;吹嘘v.喘息,鼓吹\r\n
pull	/pul/	v.拉,拖n.拉,拖;拉力,牵引力\r\n
pulse	/pʌls/	n.脉搏,脉冲\r\n
pump	/pʌmp/	n.泵v.用(泵)抽(水);打气,泵送\r\n
punch	/pʌntʃ/	n.冲压机,冲床;穿孔机v.冲压,穿孔\r\n
punctual	/'pʌŋktjuəl,-tʃuəl/	a.严守时刻的,准时的,正点的\r\n
punish	/'pʌniʃ/	v.惩罚,处罚\r\n
pupil	/'pjupəl/	n.学生,小学生;瞳孔\r\n
puppet	/'pʌpit/	n.木偶,傀儡\r\n
purchase	/'pə:tʃəs/	v.买,购买n.购买的物品\r\n
pure	/pjuə/	a.纯的,纯洁的;纯理论的,抽象的;完全的\r\n
purify	/'pjuərifai/	v.使纯净,提纯\r\n
purple	/'pə:pl/	a.紫的n.紫色\r\n
purpose	/'pə:pəs/	n.目的,意图;用途,效果\r\n
purse	/pə:s/	n.钱包\r\n
pursue	/pə'sju:,-'su:/	v.追赶,追踪;继续,从事\r\n
pursuit	/pə'sju:t/	n.追赶,追求;职业,工作\r\n
push	/puʃ/	v.推;催逼,逼迫n.推,推力;促进,推进\r\n
put	/put/	vt.放,搁,置;表达;使处于...状态,记下\r\n
puzzle	/'pʌzl/	n.难题,谜,迷惑v.(使)迷惑,(使)为难\r\n
pyramid	/'pirəmid/	n.金字塔\r\n
qualification	/,kwɔlifi'keiʃən/	n.资格,合格;限定,条件;合格证\r\n
qualify	/'kwɔlifai/	v.(使)具有资格,证明合格;限制,限定;修饰\r\n
qualitative	/'kwɔlitətiv,-tei-/	a.性质上的,定性的\r\n
quality	/'kwɔləti/	n.质量,品质,特性\r\n
quantify	/'kwɔntifai/	v.确定数量\r\n
quantitative	/'kwɔntitətiv,-tei-/	a.数量的,定量的\r\n
quantity	/'kwɔntəti/	n.量,数量;大量\r\n
quarrel	/'kwɔ:rəl/	v.争吵,争论n.争吵,争吵的原因\r\n
quart	/kwɔ:t/	n.夸脱\r\n
quarter	/'kwɔ:tə/	n.四分之一;季;一刻钟;(pl.)方向;(pl.)住处\r\n
quarterly	/'kwɔ:təli/	a.每季的ad.每季一次n.季刊\r\n
quartz	/kwɔ:ts/	n.石英\r\n
queen	/kwi:n/	n.女王,皇后,王后\r\n
queer	/kwiə/	a.奇怪的,古怪的\r\n
quench	/kwentʃ/	v.熄灭,扑灭,压制,抑制,止渴\r\n
quest	/kwest/	n.探寻,探求;寻求,追求\r\n
question	/'kwestʃən/	n.问题;询问v.询问;怀疑,对…表示疑问\r\n
questionnaire	/,kwestʃə'nεə,,kes-/	n.调查表,问卷\r\n
queue	/kju:/	n.行列,长队v.(up)排队,排队等待\r\n
quick	/kwik/	a.快的;灵敏的,伶俐的;敏锐的ad.快,迅速地\r\n
quiet	/'kwaiət/	a.安静的,平静的n.安静v.使安静,平静\r\n
quilt	/kwilt/	n.被子\r\n
quit	/kwit/	v.离开,退出;停止,放弃,辞职\r\n
quite	/kwait/	ad.十分,完全;相当,颇;的确,真正\r\n
quiver	/'kwivə/	v./n.颤抖,抖动\r\n
quiz	/kwiz/	n.小型考试,测验,问答比赛\r\n
quota	/'kwəutə/	n.(生产、进出口等的)配额,(移民的)限额\r\n
quote	/kwəut,kəut/	v.引用,援引\r\n
rabbit	/'ræbit/	n.兔子\r\n
race	/reis/	n.赛跑;人种,种族;属,种v.赛跑\r\n
racial	/'reiʃəl/	a.种的,种族的\r\n
rack	/ræk/	n.挂物架,搁物架v.使痛苦,折磨\r\n
racket	/'rækit/	n.球拍\r\n
radar	/'reidə/	n.雷达\r\n
radiant	/'reidiənt/	a.发光的,辐射的,容光焕发的\r\n
radiate	/'reidieit/	v.放射,辐射;散布,传播\r\n
radical	/'rædikəl/	a.基本的,重要的;激进的,极端的;根本的\r\n
radio	/'reidiəu/	n.收音机;无线电报,无线电话v.无线电通讯\r\n
radioactive	/,reidiəu'æktiv/	a.放射性,放射引起的\r\n
radius	/'reidiəs/	n.半径,半径范围,有效航程,范围,界限\r\n
rag	/ræɡ/	n.抹布,破布,碎布\r\n
rage	/reidʒ/	n.愤怒\r\n
raid	/reid/	n/v..袭击,搜查\r\n
rail	/reil/	n.栏杆,围栏;(pl.)铁路;铁轨;横杆,栏杆\r\n
railroad	/'reilrəud/	n.(railway)铁路v.由铁道运输\r\n
rain	/rein/	n.雨;雨天;下雨vi.下雨vt.使大量落下\r\n
rainbow	/'reinbəu/	n.虹\r\n
raise	/reiz/	v.举起,提升;增加;饲养;引起;竖起;提出\r\n
rake	/reik/	n.耙子,耙机v.耙;搜索,探索\r\n
rally	/'ræli/	v.重整,恢复,振作n.聚集,集会,拉力赛\r\n
random	/'rændəm/	a.随机的,随意的n.随机,随意\r\n
range	/reindʒ/	n.范围,领域;排列,连续;(山)脉v.排列成行\r\n
rank	/ræŋk/	n.军衔,社会阶层;排v.分等级,把…分类\r\n
rap	/ræp/	n.叩击,轻拍,斥责v.敲,拍,打,斥责,使着迷\r\n
rape	/reip/	n./vt.掠夺,蹂躏,强奸\r\n
rapid	/'ræpid/	a.快,急速的n.(pl.)急流,湍滩\r\n
rare	/rεə/	a.稀有的,难得的,珍奇的;稀薄的,稀疏的\r\n
rarely	/'rεəli/	ad.很少,难得,非常地\r\n
rash	/ræʃ/	a.轻率的,鲁莽的n.皮疹\r\n
rat	/ræt/	n.鼠\r\n
rate	/reit/	n.速率;等级;价格,费用v.估价;评级,评价\r\n
rather	/'rɑ:ðə,'ræ-/	ad.相当,有一点儿;宁愿,宁可\r\n
ratio	/'reiʃiəu,-ʃəu/	n.比,比率\r\n
rational	/'ræʃənəl/	a.理性的,合理的\r\n
raw	/rɔ:/	a.未煮过的,生的;未加工过的,未经训练的\r\n
ray	/rei/	n.光线,射线\r\n
razor	/'reizə/	n.剃刀\r\n
reach	/ri:tʃ/	v.抵达;(out)伸手,够到n.能达到的范围\r\n
react	/ri'ækt,ri:-/	v.反应,起作用;(against)反对,起反作用\r\n
read	/ri:d/	v.朗读;阅读vt.辨认,观察vi.读到,获悉\r\n
reader	/'ri:də/	n.读者;读本,读物;(英国的)大学讲师\r\n
readily	/'redili/	ad.容易地;乐意地,欣然地\r\n
reading	/'ri:diŋ/	n.读书,读物,(仪表等的)读数,阅读\r\n
ready	/'redi/	a.(for)准备好的,现成的;甘心的\r\n
real	/'riəl,ri:l/	a.真的,真实的;实际的,现实的\r\n
realise	/'riəlaiz,'ri:-/	v.(realize)认识到,体会到;实现\r\n
realistic	/,riə'listik,,ri:-/	a.现实(主义)的\r\n
reality	/ri'æləti,ri:-/	n.现实,实际;真实\r\n
really	/'riəli,'ri:li/	ad.确实,实在,真正地,果然\r\n
realm	/relm/	n.王国,国土;领域\r\n
reap	/ri:p/	v.收割,收获\r\n
rear	/riə/	n.后面,背后,后方v.饲养,抚养,栽培,举起\r\n
reason	/'ri:zən/	n.原因,理性,理智v.推理,说服,辩论,讨论\r\n
reasonable	/'ri:zənəbl/	a.合理的,有道理的;通情达理的;适度的\r\n
reassure	/,ri:ə'ʃuə/	v.使安心,使放心;使消除疑虑\r\n
rebel	/'rebəl,ri'bel/	v.反抗,反叛,起义n.叛逆者,起义者\r\n
rebellion	/ri'beljən/	n.叛乱,反抗,起义\r\n
recall	/ri'kɔ:l,'ri:kɔ:l/	v.回忆,回想;撤消,收回\r\n
recede	/ri'si:d/	v.退回,后退;收回,撤回;跌落,缩减,贬值\r\n
receipt	/ri'si:t/	n.收据,收条;收到,接到\r\n
receive	/ri'si:v/	v.收到,接到;遭受,受到;接待,接见\r\n
recent	/'ri:sənt/	a.新近的,近来的\r\n
reception	/ri'sepʃən/	n.接待,招待会;接收,接受,接收效果\r\n
recipe	/'resipi/	n.烹饪法,食谱;诀窍,方法\r\n
recipient	/ri'sipiənt/	a.接受的,感受性强的n.接受者,感受者,容器\r\n
reciprocal	/ri'siprəkəl/	a.相互的,往复的,互利的\r\n
recite	/ri'sait/	v.背诵,朗诵\r\n
reckless	/'reklis/	a.不注意的,大意的,卤莽的,不顾后果的\r\n
reckon	/'rekən/	v.计算,总计,估计,猜想,依赖\r\n
reclaim	/ri'kleim/	v.要求归还,收回;开垦\r\n
recognition	/,rekəg'niʃən/	n.认出,辨认;承认\r\n
recognize	/'rekəɡnaiz/	v.(recognise)认出,承认,公认,赏识,表扬\r\n
recollect	/,rekə'lekt/	v.回忆,想起,记起,忆起,记得\r\n
recommend	/,rekə'mend/	v.推荐,介绍;劝告,建议\r\n
reconcile	/'rekənsail/	v.使和好,调解,使调和;(to,with)使一致\r\n
record	/ri'kɔ:d,'rekɔ:d/	n.记录;最高记录;履历;唱片v.记录;录音\r\n
recorder	/ri'kɔ:də/	n.记录员;录音机\r\n
recover	/ri'kʌvə/	v.收回;(from)恢复,痊愈;重新获得\r\n
recovery	/ri'kʌvəri/	n.痊愈,复元;重获,恢复\r\n
recreation	/,rekri'eiʃən,-kri:-/	n.娱乐,消遣\r\n
recruit	/ri'kru:t/	v.征募(新兵),吸收;补充n.新成员,新兵\r\n
rectangle	/'rek,tæŋɡl/	n./数/矩形,长方形\r\n
rectify	/'rektifai/	v.纠正,整顿,/化/精馏\r\n
recur	/ri'kə:/	v.(尤指不好的事)一再发生;重现\r\n
recycle	/,ri:'saikl/	v./n.再循环,重复利用\r\n
red	/red/	a.红的,红色的n.红色;红色颜料\r\n
reduce	/ri'dju:s,-'du:s/	v.减少,缩小;简化,还原\r\n
reduction	/ri'dʌkʃən/	n.减小,减少,缩小\r\n
redundant	/ri'dʌndənt/	a.多余的,过剩的;(食物)丰富的;被解雇的\r\n
reed	/ri:d/	n.芦苇,苇丛;芦笛,牧笛\r\n
reel	/ri:l,riəl/	n.卷筒,线轴v.卷,绕\r\n
refer	/ri'fə:/	v.参考,查询;提到,引用,涉及;提交,上呈\r\n
reference	/'refərəns/	n.提及,涉及;参考,参考书目;证明书（人）\r\n
refine	/ri'fain/	v.精炼,精制,提纯;使文雅,使高尚\r\n
reflect	/ri'flekt/	v.反射,反映,表现,反省,沉思\r\n
reflection	/re'flekʃən/	n.(reflexion)映像,倒影;反省,沉思\r\n
reform	/ri'fɔ:m/	v./n.改革,改造,改良\r\n
refrain	/,ri:'frein/	v.节制,避免,制止n.(诗的)叠句\r\n
refresh	/ri'freʃ,ri:-/	v.(使)精神振作,(使)精力恢复\r\n
refreshment	/ri'freʃmənt,ri:-/	n.(pl.)点心,饮料;精力恢复,爽快\r\n
refuge	/'refju:dʒ/	n.避难处,藏身处\r\n
refugee	/,refju'dʒi:,'refjudʒi:/	n.(政治上的)避难者,难民\r\n
refund	/ri'fʌnd/	n.归还,偿还额,退款v.退还,偿还,偿付\r\n
refusal	/ri'fju:zəl,ri:-/	n.拒绝,回绝\r\n
refuse	/ri'fju:z,ri:-/	v.拒绝,谢绝n.废物,垃圾\r\n
refute	/ri'fju:t,ri:-/	v.反驳,驳斥\r\n
regard	/ri'ɡɑ:d,ri:-/	v.(as)把…看作为;考虑n.(pl.)敬重,问候\r\n
regarding	/ri'ɡɑ:diŋ,ri:-/	prep.关于,有关\r\n
regardless	/ri'ɡɑ:dlis,ri:-/	a./ad.不管…的,不顾…的,不注意的\r\n
regime	/rei'ʒi:m,ri-,ri'dʒi:m/	n.政体,制度\r\n
region	/'ri:dʒən/	n.地区,地带,行政区,(科学等)领域\r\n
register	/'redʒistə/	n./v.登记,注册v.(仪表等)指示,(邮件)挂号\r\n
regret	/ri'ɡret/	v./n.遗憾,懊悔,抱歉\r\n
regular	/'reɡjulə/	a.有规律的;整齐的,匀称的,正规的,正式的\r\n
regulate	/'reɡjuleit/	v.管制,控制;调节,校准;调整\r\n
regulation	/,reɡju'leiʃən/	n.规则,规章;调节,校准;调整\r\n
rehearsal	/ri'hə:səl/	n.排练,排演,演习,预演,试演\r\n
reign	/rein/	n./v.统治,支配,盛行n.统治时期v.占优势\r\n
rein	/rein/	n.缰绳,统治,支配v.驾驭,控制,统治\r\n
reinforce	/,ri:in'fɔ:s/	v.增援,加强\r\n
reject	/ri'dʒekt/	v.拒绝,抵制,丢弃,排斥,退掉n.落选者\r\n
rejoice	/ri'dʒɔis/	v.(使)欣喜,(使)高兴\r\n
relate	/ri'leit/	v.叙述,讲述;使互相关联\r\n
relation	/ri'leiʃən/	n.关系,联系;亲属,亲戚\r\n
relationship	/ri'leiʃənʃip/	n.关系,联系\r\n
relative	/'relətiv/	a.相对的,比较的,有关系的n.亲戚,关系词\r\n
relativity	/,relə'tivəti/	n.相关(性);相对论\r\n
relax	/ri'læks/	v.(使)松驰,放松\r\n
relay	/'ri:lei,ri'lei/	v.中继,转播,接力n.接替人员,替班\r\n
release	/ri'li:s/	v.释放,解放;发表,发行n.释放,豁免,放松\r\n
relevant	/'reləvənt/	a.有关的,中肯的,相应的,实质性的\r\n
reliable	/ri'laiəbl/	a.可靠的,可信赖的,确实的\r\n
reliance	/ri'laiəns/	n.信任,信心,依靠,依靠的人或物\r\n
relief	/ri'li:f/	n.(痛苦等)减轻,解除;援救,救济\r\n
relieve	/ri'li:v/	v.减轻,解除,援救,救济,换班\r\n
religion	/ri'lidʒən/	n.宗教,信仰\r\n
religious	/ri'lidʒəs/	a.宗教的,信教的,虔诚的\r\n
relish	/'reliʃ/	n.美味,味道,调味品,食欲,乐趣v.喜欢,品味\r\n
reluctant	/ri'lʌktənt/	a.不愿的,勉强的\r\n
rely	/ri'lai/	v.(on)依赖,依靠;信赖,信任\r\n
remain	/ri'mein/	v.剩下,余留;留待,尚须;仍然是,依旧是\r\n
remainder	/ri'meində/	n.剩余物,剩下的;余数,余项\r\n
remains	/ri'meinz/	n.(pl.)剩余,残余,遗迹\r\n
remark	/ri'mɑ:k/	n.(about,on)评语,意见v.(on)评论;注意到\r\n
remarkable	/ri'mɑ:kəbl/	a.值得注意的;显著的,异常的,非凡的\r\n
remedy	/'remidi/	n.药品;治疗措施v.治疗,医治;纠正,补救\r\n
remember	/ri'membə/	v.记住;(to)转达问候,代…致意,代…问好\r\n
remind	/ri'maind/	v.(of)提醒,使想起\r\n
remnant	/'remnənt/	n.剩余(物),零料,遗迹/风/a.剩余的,残留的\r\n
remote	/ri'məut/	a.远的,遥远的,疏远的,偏僻的,细微的\r\n
removal	/ri'mu:vəl/	n.移动,迁居;除去\r\n
remove	/ri'mu:v/	v.移动,脱掉,调动,免职\r\n
renaissancen.	/theR-/	文艺复兴(时期);新生,复兴\r\n
render	/'rendə/	v.使得,致使;提出,提供,呈报\r\n
renew	/ri'nju:/	v.(使)更新,恢复,重新开始,继续\r\n
renovate	/'renəuveit/	v.更新,修复\r\n
rent	/rent/	v.租,租赁n.租金\r\n
repair	/ri'pεə/	n.修理,修补v.补救,纠正;修理\r\n
repay	/ri:'pei,ri-/	v.偿还,报答\r\n
repeat	/ri'pi:t/	v.重复,重说,重做n.重复\r\n
repeatedly	/rɪˈpiːtɪdli/	ad.重复地,再三地\r\n
repel	/ri'pel/	v.击退,抵制,使厌恶,使不愉快\r\n
repertoire	/'repətwɑ:/	n.节目,全部剧目,保留剧目,全部技能\r\n
repetition	/,repi'tiʃən/	n.重复,反复\r\n
replace	/ri'pleis/	vt.取代,替换,代替,把...放回原处\r\n
replacement	/ri'pleismənt/	n.取代,替换,替换物,代替物\r\n
reply	/ri'plai/	v./n.(to)回答,答复,以…作答\r\n
report	/ri'pɔ:t/	n./v.报告,汇报;传说,传阅\r\n
reporter	/ri'pɔ:tə/	n.报告人,通讯员;记者,报导者\r\n
represent	/,repri'zent/	v.描述,表示;代表,代理;阐明,说明\r\n
representative	/,repri'zentətiv/	n.代表,代理人a.(of)典型的,有代表性的\r\n
repression	/ri'preʃən/	n.压抑,压制,镇压\r\n
reproach	/ri'prəutʃ/	v./n.责备,指责\r\n
reproduce	/,ri:prə'dju:s/	v.生殖;翻版;繁殖;复制,仿造\r\n
reptile	/'reptail,-til/	n.爬行动物\r\n
republic	/ri'pʌblik/	n.共和国,共和政体\r\n
republican	/ri'pʌblikən/	a.共和的\r\n
reputation	/,repju'teiʃən/	n.名誉,名声,声望\r\n
request	/ri'kwest/	v./n.请求,要求\r\n
require	/ri'kwaiə/	v.需要;(of)要求,命令\r\n
requirement	/ri'kwaiəmənt/	n.(for)需要,需要的东西,要求\r\n
rescue	/'reskju:/	v./n.营救,援救\r\n
research	/ri'sə:tʃ,'ri:s-/	v./n.(into,on)研究,调查\r\n
resemblance	/ri'zembləns/	n.相似,相似性/点,物/\r\n
resemble	/ri'zembl/	v.像,类似\r\n
resent	/ri'zent/	v.对…表示忿恨,怨恨\r\n
reservation	/,rezə'veiʃən/	n.保留,保留意见;预定,预订\r\n
reserve	/ri'zə:v/	n.储备(物),储备金;缄默v.保留,储备;预定\r\n
reservoir	/'rezəvwɑ:/	n.水库,蓄水池\r\n
residence	/'rezidəns/	n.住处,住宅\r\n
resident	/'rezidənt/	n.居民,常住者a.居住的\r\n
resign	/ri'zain/	v.辞去,辞职,使听从(于),使顺从\r\n
resist	/ri'zist/	v.抵抗,反抗;抗,忍得住,抵制\r\n
resistance	/ri'zistəns/	n.(to)抵抗,反抗;抵抗力,阻力;电阻\r\n
resistant	/ri'zistənt/	a.(to)抵抗的,有抵抗力的\r\n
resolute	/'rezəlju:t,-lət/	a.坚决的,果断的\r\n
resolution	/,rezə'lu:ʃən,-,lju:-/	n.坚决,决心;决定,决议\r\n
resolve	/ri'zɔlv/	v.决心;(使)分解,溶解;决议n.解决;决心\r\n
resort	/ri'zɔ:t/	v.凭借,求助,诉诸n.度假胜地,常去之处,手段\r\n
resource	/ri'sɔ:s,-'zɔ:s/	n.(pl.)资源,财力;办法,智谋;应变之才\r\n
respect	/ri'spekt/	n./v.尊敬,尊重n.敬意,问候,关系,方面\r\n
respective	/ri'spektiv/	a.各自的,各个的\r\n
respond	/ri'spɔnd/	v.回答,响应,作出反应\r\n
response	/ri'spɔns/	n.回答,响应,反应\r\n
responsibility	/ri,spɔnsə'biləti/	n.责任,责任心;职责,任务\r\n
responsible	/ri'spɔnsəbl/	a.(for,to)应负责的;可靠的;责任重大的\r\n
rest	/rest/	n.休息;剩余部分v.休息;睡;放,靠,搁\r\n
restaurant	/'restərɔŋ,-rɔnt/	n.餐馆,饭店\r\n
restless	/'restlis/	a.得不到休息的;不平静的;坐立不安的\r\n
restore	/ri'stɔ:/	v.恢复,使回复;归还,交还;修复,重建\r\n
restrain	/ri'strein/	v.(from)抑制,制止\r\n
restraint	/ri'streint/	n.抑制,制止\r\n
restrict	/ri'strikt/	v.限制,约束\r\n
result	/ri'zʌlt/	n.结果,成绩v.结果,致使,导致,由…而造成\r\n
resultant	/ri'zʌltənt/	a.作为结果而发生的;合成的\r\n
resume	/ri'zju:m,-'zu:m/	n.个人简历v.再继续,重新开始;再用;恢复\r\n
retail	/'ri:teil/	n.零售\r\n
retain	/ri'tein/	v.保持,保留\r\n
retention	/ri'tenʃən/	n.保留,保持,保持力,记忆力\r\n
retire	/ri'taiə/	v.退休,引退;退却,撤退;就寝\r\n
retort	/ri'tɔ:t/	n./v.报复,反击,反驳\r\n
retreat	/ri'tri:t/	v.撤退,退却\r\n
retrieve	/ri'tri:v/	vt.重新得到,取回;挽回,补救;检索\r\n
retrospect	/'retrəuspekt/	v./n.回顾,回想,追溯/反/foresee\r\n
return	/ri'tə:n/	v./n.返回,回来;归还,送还;回答\r\n
reveal	/ri'vi:l/	v.展现,显示,揭示,揭露,告诉,泄露\r\n
revelation	/,revə'leiʃən/	n.揭示,揭露,显示,启示,新发现,被揭露的事\r\n
revenge	/ri'vendʒ/	n.报复,复仇v.替…报仇\r\n
revenue	/'revənju:,-nu:/	n.财政收入,税收\r\n
reverse	/ri'və:s/	n.相反;背面a.相反的v.颠倒,倒转\r\n
review	/ri'vju:/	v.回顾,复习n.回顾,复习;评论\r\n
revise	/ri'vaiz,'ri:vaiz/	v.修订,校订;修正,修改\r\n
revive	/ri'vaiv/	v.恢复;(使)复苏\r\n
revolt	/ri'vəult,-'vɔ:lt/	v./n.反抗,起义\r\n
revolution	/,revə'lju:ʃən/	n.革命;旋转,转数\r\n
revolutionary	/,revə'lju:ʃənəri/	a.革命的,革新的n.革命者\r\n
revolve	/ri'vɔlv,-'vɔ:lv/	v.(使)旋转;考虑;【天】公转,循环\r\n
reward	/ri'wɔ:d/	n.(for)报酬,赏金v.(for)酬劳;酬谢\r\n
rhythm	/'riðəm,'riθəm/	n.节奏,韵律\r\n
rib	/rib/	n.肋骨,肋状物\r\n
ribbon	/'ribən/	n.缎带,丝带,带,带状物\r\n
rice	/rais/	n.稻,米\r\n
rich	/ritʃ/	a.富的,有钱的;富饶的;(in)充足的,丰富的\r\n
rid	/rid/	v.(of)使摆脱,使去掉\r\n
riddle	/'ridl/	n.谜,谜语\r\n
ride	/raid/	v./n.骑,乘\r\n
ridge	/ridʒ/	n.岭,山脉;屋脊;鼻梁\r\n
ridiculous	/ri'dikjuləs/	a.荒谬的,可笑的\r\n
rifle	/'raifl/	n.步枪\r\n
right	/rait/	a.右的,正确的n.右,权利ad.在右边,正确地\r\n
rigid	/'ridʒid/	a.刚性的;刻板的;严厉的\r\n
rigorous	/'riɡərəs/	a.严格的,严厉的,严酷的,严密的,严谨的\r\n
rim	/rim/	n.(圆物的)边,边缘;(眼镜)框\r\n
ring	/riŋ/	n.戒指;环;铃声;(打)电话v.按(铃),敲(钟)\r\n
riot	/'raiət/	n.暴(骚)乱,蔓延,彩色缤纷v.骚乱,暴动\r\n
rip	/rip/	v.撕,剥,劈,锯,裂开,撕裂n.裂口,裂缝\r\n
ripe	/raip/	a.熟的,成熟的;(for)时机成熟的\r\n
rise	/raiz,rais/	v.升起;起立;上涨;起义n.上涨,增高;起源\r\n
risk	/risk/	v.冒…的危险n.冒险;风险\r\n
ritual	/'ritjuəl,-tʃu-/	a.宗教仪式的,典礼的n.(宗教)仪式,典礼\r\n
rival	/'raivəl/	n.竞争者,对手v.竞争,对抗a.竞争的\r\n
river	/'rivə/	n.河流\r\n
road	/rəud/	n.路,道路,途径\r\n
roar	/rɔ:/	n./v.吼叫,怒号;轰鸣,咆哮\r\n
roast	/rəust/	v.烤,炙,烘\r\n
rob	/rɔb/	v.(of)抢劫,盗取;非法剥夺\r\n
robe	/rəub/	n.长袍,上衣\r\n
robot	/'rəubɔt,-bət,'rɔbət/	n.机器人,自动机械\r\n
robust	/rəu'bʌst,'rəubʌst/	a.强健的,雄壮的,精力充沛的,坚固的,浓的\r\n
rock	/rɔk/	n.岩石,石块v.摇,摇动\r\n
rocket	/'rɔkit/	n.火箭\r\n
rod	/rɔd/	n.杆,棒\r\n
role	/rəul/	n.角色,作用,任务,职责\r\n
roll	/rəul/	v.滚动;使摇摆;卷,卷起n.卷,卷形物;名单\r\n
romance	/rəu'mæns,'rəumæns/	n.传奇,爱情故事\r\n
romantic	/rəu'mæntik/	a.浪漫的,传奇式的;不切实际的,好幻想的\r\n
roof	/ru:f,ruf/	n.屋顶,顶\r\n
room	/ru:m,rum/	n.房间,室,空间,地方;余地\r\n
root	/ru:t,rut/	n.根,根部;根本,根源v.(使)生根,(使)扎根\r\n
rope	/rəup/	n.绳,索\r\n
rose	/rəʊz/	n.玫瑰,蔷薇\r\n
rot	/rɔt/	v.(使)腐烂,(使)腐败,腐朽\r\n
rotary	/'rəutəri/	a.旋转的\r\n
rotate	/rəu'teit,'rəuteit/	v.(使)旋转\r\n
rotten	/'rɔtən/	a.腐烂的,腐朽的\r\n
rough	/rʌf/	a.粗糙的;粗略的,大致的;粗野的,粗暴的\r\n
round	/raund/	a.圆的prep.围绕ad.在周围v.绕行n.(一)回合\r\n
roundabout	/'raundə,baut/	a.迂回的,转弯抹角的n.环状交叉路口\r\n
rouse	/rauz/	vt./vi.唤醒,唤起;激励;激起\r\n
route	/ru:t,raut/	n.路线,路程\r\n
routine	/ru:'ti:n/	n.例行公事,常规a.常规的,例行的\r\n
row	/rəu/	n.(一)排,(一)行;吵嚷v.划(船等),荡桨\r\n
royal	/'rɔiəl/	a.王室的,皇家的;第一流的,高贵的\r\n
royalty	/'rɔiəlti/	n.皇家,皇族\r\n
rub	/rʌb/	v.擦,摩擦\r\n
rubber	/'rʌbə/	n.橡皮,橡胶;橡胶制品,胶鞋\r\n
rubbish	/'rʌbiʃ/	n.垃圾,废物;废话\r\n
ruby	/'ru:bi/	n.红宝石\r\n
rude	/ru:d/	a.粗鲁的;猛烈的,残暴的;粗糙的,粗陋的\r\n
rug	/rʌɡ/	n.(小)地毯;围毯\r\n
ruin	/'ruin,'ru:-/	v.毁灭;(使)破产n.毁灭,崩溃;(pl.)废墟\r\n
rule	/ru:l/	v.统治;支配;裁定n.规章,条例;习惯;统治\r\n
ruler	/'ru:lə/	n.统治者,支配者;尺,直尺\r\n
rumor	/'ru:mə/	n.(rumour)传闻,谣言\r\n
run	/rʌn/	v.奔,跑;流,淌;蔓延,伸展;经营;运转\r\n
rural	/'ruərəl/	a.乡下的,田园的,乡村风味的\r\n
rush	/rʌʃ/	v.(使)冲;奔n.冲,急速行进a.(交通)繁忙的\r\n
rust	/rʌst/	n.铁锈v.(使)生锈\r\n
ruthless	/'ru:θlis/	a.残酷的,无情的\r\n
sack	/sæk/	n.袋,包,麻袋v.解雇\r\n
sacred	/'seikrid/	a.神圣的;宗教的;庄严的\r\n
sacrifice	/'sækrifais/	n.牺牲,牺牲品;祭品v.(for,to)牺牲,献出\r\n
sad	/sæd/	a.悲哀的,忧愁的\r\n
saddle	/'sædl/	n.鞍,马鞍,鞍状物\r\n
safe	/seif/	a.安全的,牢靠的;谨慎的,可靠的n.保险箱\r\n
safeguard	/'seifɡɑ:d/	v.维护,保护,捍卫n.安全装置,安全措施\r\n
safety	/'seifti/	n.安全,保险;安全设备,保险装置\r\n
sail	/seil/	n.帆,航行v.航行\r\n
sailor	/'seilə/	n.水手,海员\r\n
saint	/seint/	n.圣人,基督教徒;(S-或St.用于人,地名前)圣\r\n
sake	/seik/	n.缘故,理由\r\n
salad	/'sæləd/	n.色拉,凉拌菜\r\n
salary	/'sæləri/	n.薪金,薪水\r\n
sale	/seil/	n.出售,上市;贱卖,廉价出售;销售额\r\n
salesman	/'seilzmən/	n.售货员,推销员\r\n
salt	/sɔ:lt/	n.盐,盐,类v.腌,盐渍\r\n
salute	/sə'lju:t,sɑ:'lu:te/	v./n.敬礼,鸣礼炮;迎接,欢迎\r\n
salvation	/sæl'veiʃən/	n.拯救,救助;救济(者,品),救助工具;救世主\r\n
same	/seim/	a.相同的pron.相同的人(或物)ad.同样地\r\n
sample	/'sɑ:mpl,'sæ-/	n.样品,实例,标本,抽样检查v.取样,采样\r\n
sanction	/'sæŋ,kʃən/	n./v.批准,同意,支持,认可n.处罚,制裁\r\n
sand	/sænd/	n.沙;(pl.)沙滩,沙地\r\n
sandwich	/'sænwidʒ/	n.三明治,夹肉面包v.夹入,挤进\r\n
sane	/sein/	a.心智健全的,神志清醒的,明智的,稳健的\r\n
sarcastic	/sɑ:'kæztik/	a.讽刺的\r\n
satellite	/'sætəlait/	n.卫星,人造卫星;附属物\r\n
satire	/'sætaiə/	n.讽刺,讽刺文学,讽刺作品\r\n
satisfaction	/,sætis'fækʃən/	n.满足,满意;乐事,愉快\r\n
satisfactory	/,sætis'fæktəri/	a.令人满意的,圆满的,良好的,符合要求的\r\n
satisfy	/'sætisfai/	v.满意,使满意,使相信,说服\r\n
saturate	/'sætʃəreit,'sætʃərit/	vt.使湿透,浸透;使充满,使饱和\r\n
Saturday	/ˈsætədeɪ/	n.星期六\r\n
sauce	/sɔ:s/	n.酱汁,调味汁\r\n
saucer	/'sɔ:sə/	n.茶托,碟子\r\n
sausage	/'sɔsidʒ,'sɔ:-/	n.香肠,腊肠\r\n
savage	/'sævidʒ/	a.野蛮的;凶恶的,残暴的n.野人,未开化的人\r\n
save	/seiv/	v.救,拯救;储蓄,贮存;节省\r\n
saving	/ˈseɪvɪŋ/	n.挽救,救助,节约,储蓄;(pl.)储蓄金,存款\r\n
saw	/sɔ:/	n.锯子,锯床v.锯,锯开\r\n
say	/sei/	vt.说,讲;说明;比如说vi.说,发表意见\r\n
scale	/skeil/	n.刻度;天平,磅秤;比例尺;规模;音阶;鱼鳞\r\n
scan	/skæn/	v.细看,审视;浏览;扫描n.扫描\r\n
scandal	/'skændəl/	n.丑闻,诽谤,耻辱,流言蜚语,反感,公愤\r\n
scar	/skɑ:/	n.疤,疤痕;创伤v.使留下伤痕,创伤\r\n
scarce	/skεəs/	a.缺乏的,不足的;稀少的,罕见的\r\n
scarcely	/'skεəsli/	ad.几乎不,简直没有,勉强\r\n
scare	/skεə/	n.惊恐,恐慌v.惊吓,受惊\r\n
scarf	/skɑ:f/	n.围巾,头巾,领巾,领带\r\n
scatter	/'skætə/	v.散开,驱散;散布,散播\r\n
scene	/si:n/	n.景色,景象,舞台;(戏)一场\r\n
scenery	/'si:nəri/	n.风景,舞台布景\r\n
scent	/sent/	n.气味,香味,香水,线索,嗅觉v.嗅,发觉\r\n
schedule	/'ʃədju:əl,'skedʒu:əln.时间表,进度表v.安排,预定\r\n
scheme	/ski:m/	n.计划,方案;阴谋;配置v.计划,策划;阴谋\r\n
scholar	/'skɔlə/	n.学者\r\n
scholarship	/'skɔləʃip/	n.奖学金;学问,学识\r\n
school	/sku:l/	n.学校,(大学里的)学院;上学,学业;学派\r\n
science	/'saiəns/	n.科学;学科\r\n
scientific	/,saiən'tifik/	a.科学上的\r\n
scientist	/'saiəntist/	n.科学家\r\n
scissors	/'sizəz/	n.剪子\r\n
scold	/skəuld/	v.责骂,训斥\r\n
scope	/skəup/	n.(活动)范围;机会,余地\r\n
score	/skɔ:/	n.得分,分数;二十v.得(分),记(…的)分数\r\n
scorn	/skɔ:n/	v./n.轻蔑,藐视\r\n
scout	/skaut/	n.侦察员,侦察机(舰)v.搜索,侦察\r\n
scramble	/'skræmbl/	vi.(快速地)爬,攀登;互相争夺,争先\r\n
scrap	/skræp/	n.碎片;废料v.废弃,报废\r\n
scrape	/skreip/	v.刮(掉),擦过,勉强通过n.刮,擦痕,刮擦声\r\n
scratch	/skrætʃ/	v.抓,搔,扒n.抓,搔,抓痕;起跑线\r\n
scream	/skri:m/	v./n.尖声叫,喊叫着说出,(风)呼啸\r\n
screen	/skri:n/	n.屏幕,屏风;帘v.掩蔽,包庇;筛选\r\n
screw	/skru:/	n.螺旋,螺丝(钉)v.拧,拧紧\r\n
script	/skript/	n.剧本(原稿);手稿,原稿;笔迹,手迹\r\n
scrutiny	/'skru:tini/	n.周密的调查;仔细看;监视;选票复查\r\n
sculpture	/'skʌlptʃə/	n.雕刻(术),雕塑(术);雕刻作品\r\n
sea	/si:/	n.海,海洋,大量\r\n
seal	/si:l/	n.封铅,封条;印,图章;海豹v.封,密封\r\n
seam	/si:m/	n.缝,接缝;缝合,接合;vi.裂开,产生裂缝\r\n
search	/sə:tʃ/	v./n.(for)搜索,寻找,探查\r\n
seaside	/'si:said/	n.海滨,海边\r\n
season	/'si:zən/	n.季,季节,时节\r\n
seat	/si:t/	n.座位,底座;所在地,场所v.使坐下\r\n
second	/'sekənd/	a.第二;次等的,二等的n.秒v.赞成,附和\r\n
secondary	/'sekəndəri/	a.次要的,二级的;中级的,第二的\r\n
secret	/'si:krit/	a.秘密的,机密的n.秘密\r\n
secretary	/'sekrətəri/	n.秘书,书记;部长,大臣\r\n
section	/'sekʃən/	n.章节,部分;地区,部门,科;截面,剖面\r\n
sector	/'sektə/	n.部门,部分;防御地段,防区;扇形\r\n
secure	/si'kjuə/	a.(from,against)安全的,放心的v.得到;防护\r\n
security	/si'kjuəriti/	n.安全(感),防御(物),保证(人),(pl.)证券\r\n
see	/si:/	vt.看见;会面;探望;知道,获悉;送行\r\n
seed	/si:d/	n.种子v.播种;结实,结籽\r\n
seek	/si:k/	v.(after,for)寻找,探索;试图,企图\r\n
seem	/si:m/	v.好像,似乎\r\n
seemingly	/ˈsiːmɪŋli/	ad.外观上,表面上\r\n
segment	/'seɡmənt,seɡ'ment/	n.段,片,节,部分\r\n
segregate	/'seɡriɡit,-ɡeit/	vt.使···分开,隔离（病患等）\r\n
seize	/si:z/	v.抓住,逮住;夺取,占领;没收,查封\r\n
seldom	/'seldəm/	ad.很少,不常\r\n
select	/si'lekt/	v.选择,挑选a.精选的,选择的\r\n
selection	/si'lekʃən/	n.选择,挑选;选集,精选物\r\n
self	/self/	n.自我,自己(pl.selves)\r\n
selfish	/'selfiʃ/	adj.自私的,利己的\r\n
sell	/sel/	v.卖,出售\r\n
semester	/si'mestə/	n.学期\r\n
semiconductor	/,semikən'dɔktə/	n.半导体\r\n
seminar	/'seminɑ:/	n.(大学的)研究班,研讨会\r\n
senate	/'senit/	n.参议院,上院\r\n
senator	/'senətə/	n.参议员\r\n
send	/send/	v.(sent,sent)1.打发;派遣2.送;寄出\r\n
senior	/'si:njə/	a.年长的;地位较高的n.(大学)四年级学生\r\n
sensation	/sen'seiʃən/	n.感觉,知觉;激动,轰动,轰动一时的事情\r\n
sense	/sens/	n.感官;感觉;判断力;意义v.觉得,意识到\r\n
sensible	/'sensəbl/	a.明智的,达理的;可觉察的,明显的\r\n
sensitive	/'sensitiv/	a.(to)敏感的,易受伤害的;灵敏的\r\n
sentence	/'sentəns/	n.句子;判决,宣判v.宣判,判决\r\n
sentiment	/'sentimənt/	n.感情,柔情;看法;感觉\r\n
separate	/'sepəreit,'sepərit/	a.(from)分离的,分开的\r\n
September	/'si:kwəns/	n.九月\r\n
sequence	/'si:kwəns/	n.先后,次序;连续,数列\r\n
serial	/'siəriəl,'si:r-/	n.连载小说,连续剧;连载刊物a.连续的\r\n
series	/'siəri:z,-riz/	n.一系列,连续;丛书\r\n
serious	/'siəriəs,'si:r-/	a.严肃的;主要的;严重的,危急的;认真的\r\n
servant	/'sə:vənt/	n.仆人\r\n
serve	/sə:v/	v.服务,尽责;招待,侍候;符合,适用\r\n
service	/'sə:vis/	n.服务;公共设施;维修保养;行政部门v.维修\r\n
session	/'seʃən/	n.(一届)会议,一段时间\r\n
set	/set/	n.一套,一副,装置,接受机v.提出,调整,日落\r\n
setback	/'setbæk/	n.挫折;失效;复发;倒退\r\n
setting	/'setiŋ/	n.安置;落山;(固定东西的)柜架底座;环境\r\n
settle	/'setl/	v.安定,安顿;停息;定居;解决,调停\r\n
settlement	/'setlmənt/	n.解决,决定,调停;居留区,住宅区\r\n
seven	/'sevən/	num.七,七个(人或物)\r\n
several	/'sevərəl/	a.几个,若干,数个;各个的,各自的\r\n
severe	/si'viə/	a.严厉的;剧烈的,严重的,严峻的,艰难的\r\n
sew	/səu/	v.缝,缝纫\r\n
sex	/seks/	n.性别,性\r\n
shabby	/'ʃæbi/	a.简陋的,破旧的,卑鄙的,不公平的\r\n
shade	/ʃeid/	n.荫,阴影;遮光物,罩v.遮蔽,遮光\r\n
shadow	/'ʃædəu/	n.阴影,影子,荫;暗处,阴暗\r\n
shady	/'ʃeidi/	a.成荫的,多荫的;可疑的,靠不住的\r\n
shaft	/ʃɑ:ft,ʃæft/	n.轴;杆状物\r\n
shake	/ʃeik/	n./v.摇动,摇;颤抖,震动\r\n
shall	/ʃæl,弱ʃəl,ʃl,ʃə,ʃ/	aux.v.(我,我们)将要,会;必须,应该\r\n
shallow	/'ʃæləu/	a.浅的,浅薄的n.浅滩,浅处\r\n
sham	/ʃæm/	n./a.假冒(的),虚伪(的)\r\n
shame	/ʃeim/	n.羞耻,耻辱;可耻的人(或事物)v.使羞愧\r\n
shampoo	/ʃæm'pu:/	n.洗发膏,香波;洗发,洗头v.洗发,洗头\r\n
shape	/ʃeip/	n.形状,外形;情况,状态;种类v.成型,塑造\r\n
share	/ʃεə/	v.(with)分配,共用;分担n.一份,份额;股份\r\n
shark	/ʃɑ:k/	n.鲨鱼\r\n
sharp	/ʃɑ:p/	a.锋利的;轮廓分明的;急转的ad.(指时刻)正\r\n
shatter	/'ʃætə/	n.碎片;粉碎　v.粉碎;使疲惫;使震骇\r\n
shave	/ʃeiv/	v.剃,刮,刨,削n.刮脸\r\n
she	/ʃi:/	pron.(主格)她\r\n
shear	/ʃiə/	v.剪,修剪\r\n
shed	/ʃed/	v.流出;发散,散发,脱落,脱去n.棚,小屋\r\n
sheep	/ʃip/	n.(绵)羊;易受人摆布的人\r\n
sheer	/ʃiə/	a.纯粹的,十足的,全然的;陡峭的,险峻的\r\n
sheet	/ʃi:t/	n.被单;(一)张,(一)片,薄片;大片\r\n
shelf	/ʃelf/	n.架子,搁板\r\n
shell	/ʃel/	n.壳,贝壳;炮弹\r\n
shelter	/'ʃeltə/	n.掩蔽处;掩蔽,保护v.掩蔽,躲避,庇护\r\n
shepherd	/'ʃepəd/	n.牧民,牧羊人\r\n
shield	/ʃi:ld/	n.防护物,护罩;盾,盾状物v.保护,防护\r\n
shift	/ʃift/	v.替换,转移n.转换,转变;(轮)班,(换)班\r\n
shilling	/'ʃiliŋ/	n.先令\r\n
shine	/ʃain/	v.照耀,发光;擦亮n.光泽,光\r\n
ship	/ʃip/	n.船舶,舰艇v.装运,航运,运送;发货\r\n
shipment	/'ʃipmənt/	n.装船,装运;装载的货物,装货量\r\n
shirt	/ʃə:t/	n.衬衫\r\n
shiver	/'ʃivə/	v./n.战栗,发抖\r\n
shock	/ʃɔk/	n.震动;电击,触电;休克v.(使)震动/震惊\r\n
shoe	/ʃu:/	n.鞋\r\n
shoot	/ʃu:t/	v.发射;掠过,疾驰而过n.嫩枝,苗,射击\r\n
shop	/ʃɔp/	n.商店,店铺;工厂,车间v.买东西\r\n
shopkeeper	/'ʃɔp,ki:pə/	n.店主,老板\r\n
shore	/ʃɔ:/	n.海滨,湖滨\r\n
short	/ʃɔ:t/	a.短的,矮的;(of)缺乏,不足n.(pl.)短裤\r\n
shortage	/'ʃɔ:tidʒ/	n.不足,缺少\r\n
shortcoming	/'ʃɔ:t'cʌmiŋ/	n.短处,缺点\r\n
shorthand	/'ʃɔ:thænd/	n.速记\r\n
shortly	/'ʃɔ:tli/	ad.立刻,不久;不耐烦地,简慢地\r\n
shot	/ʃɔt/	n.开枪,射击;投篮;弹丸,炮弹,子弹\r\n
should	/ʃud,弱ʃəd,ʃd/	aux.v.应该;万一;可能,该;就;竟然会\r\n
shoulder	/'ʃəuldə/	n.肩,肩部v.肩负,承担\r\n
shout	/ʃaut/	v.大声叫,喊,呼出n.呼喊,叫\r\n
shove	/ʃʌv/	vt.乱推;乱塞vi.用力推,挤n.猛推\r\n
show	/ʃəu/	n.节目,表演v.上演(戏剧等),放映(电影)\r\n
shower	/'ʃauə/	n.阵雨;沐浴;(一)阵/大批v.下阵雨,倾注\r\n
shrewd	/ʃru:d/	a.机灵的,敏锐的;精明的\r\n
shrink	/ʃriŋk/	v.起皱,收缩;退缩,畏缩\r\n
shrug	/ʃrʌɡ/	vt./n.耸肩(表示冷淡、怀疑、无奈、不满等)\r\n
shut	/ʃʌt/	v.关,关闭\r\n
shutter	/'ʃʌtə/	n.百叶窗;(照相机)快门;关闭装置\r\n
shuttle	/'ʃʌtl/	n.往返汽车/列车/飞机;穿梭v.往返穿梭\r\n
shy	/ʃai/	a.怕羞的,腼腆的;胆怯的vi.惊退,畏缩\r\n
sick	/sik/	a.有病的,患病的;恶心的,想吐的\r\n
side	/said/	n.旁边,侧面;坡,岸;一边/侧/方vi.支持\r\n
sideways	/'saidweiz/	ad./a.向旁边(的),侧身,横着(的),斜着(的)\r\n
siege	/si:dʒ/	n.包围,围攻,围困\r\n
sigh	/sai/	n.叹息,叹息声v.叹息,叹气\r\n
sight	/sait/	n.视力;望见,瞥见;视域;眼界;情景,奇观\r\n
sightseeing	/'saitsi:iŋ/	n.观光,游览\r\n
sign	/sain/	n.标记,招牌;征兆,迹象v.签名(于),署名(于)\r\n
signal	/'siɡnəl/	n.信号,暗号v.发信号,用信号通知\r\n
signature	/'signətʃə/	n.签名,署名,签字\r\n
significance	/siɡ'nifikəns/	n.意义,含义;重要性,重要的\r\n
significant	/sig'nifikənt/	a.有意义的;重大的,重要的\r\n
signify	/'signifai/	v.表示,意味;要紧,有重要性\r\n
silence	/'sailəns/	n.寂静,沉默v.使沉默,使安静\r\n
silent	/'sailənt/	a.寂静,沉默的\r\n
silicon	/'silikən,-kɔn/	n.硅\r\n
silk	/silk/	n.丝,绸\r\n
silly	/'sili/	a.傻的,糊涂的,愚蠢的\r\n
silver	/'silvə/	n.银;银器;银币v.镀银\r\n
similar	/'similə/	a.(to)相似的,类似的\r\n
simple	/'simpl/	a.简单的;单纯的,直率的;迟钝的,头脑简单的\r\n
simplicity	/sim'plisiti/	n.简单,简易;朴素;直率,单纯\r\n
simplify	/'simplifai/	v.简化,使单纯\r\n
simply	/'simpli/	ad.简单地;完全,简直;仅仅,只不过;朴素地\r\n
simulate	/'simjuleit/	v.模仿,模拟;假装,冒充\r\n
simultaneous	/,siməl'teiniəs/	a.同时的,同时存在的\r\n
sin	/sin/	n.罪,罪恶v.犯罪\r\n
since	/sins/	prep.自从conj.自从;因为,既然ad.后来\r\n
sincere	/sin'siə/	a.诚挚的,真实的,诚恳的\r\n
sing	/siŋ/	v.唱,演唱;鸡叫\r\n
single	/'siŋɡl/	a.单人的;单一的,单个的;未婚的,独身的\r\n
singular	/'siŋɡjulə/	a.非凡的,卓越的;单数的\r\n
sink	/siŋk/	v.(使)下沉,下落n.水槽,水池\r\n
sip	/sip/	v.小口地喝,抿,呷n.一小口的量\r\n
sir	/sə:,弱sə/	n.先生,长官;/S-用于姓名前/…爵士\r\n
siren	/'saiərən/	n.警报声,警报器\r\n
sister	/'sistə/	n.姐,妹;护士长;修女,女教士\r\n
sit	/sit/	vi.坐,坐下;位于;栖息;孵卵vt.使就坐\r\n
site	/sait/	n.位置,场所,地点\r\n
situated	/'sitjueitid,-tʃu-/	a.坐落在…的\r\n
situation	/,sitju'eiʃən,-tʃu-/	n.形势,处境,状况;位置,场所;职位,职务\r\n
six	/siks/	num.六pron./a.六(个,只...)\r\n
size	/saiz/	n.大小,尺寸,规模;尺码\r\n
skate	/skeit/	v.溜冰,滑冰n.冰鞋\r\n
skeleton	/'skelitən/	n.骨骼;骨架,框架;梗概,提要\r\n
skeptical	/'skeptikəl/	a.怀疑的/英/sceptical\r\n
sketch	/sketʃ/	n.素描;略图,草图;梗概v.绘略图,速写,写生\r\n
ski	/ski:,ʃi:/	n.雪橇v.滑雪\r\n
skill	/skil/	n.技能,技巧,手艺;熟练\r\n
skilled	/skild/	a.(in)熟练的,有技能的;需要技能的\r\n
skillful	/'skilful/	a.(skilful)(in,at)灵巧的,娴熟的\r\n
skim	/skim/	vt.撇去(液体表面)之漂浮物vi.轻轻掠过\r\n
skin	/skin/	n.皮,皮肤;兽皮,皮毛;外皮,外壳v.剥皮\r\n
skip	/skip/	vi.略过,跳过n.跳跃vt.故意忽略;略过\r\n
skirt	/skə:t/	n.裙子;边缘,郊区\r\n
skull	/skʌl/	n.头盖骨,颅骨\r\n
sky	/skai/	n.天空;/pl./天色;气候\r\n
skyscraper	/'skai,skreipə/	n.摩天大楼\r\n
slack	/slæk/	a.懈怠的,松驰的;萧条的n.淡季;(pl.)便裤\r\n
slam	/slæm/	v.(门、窗等)砰地关上n.猛然关闭的声音\r\n
slap	/slæp/	n./v.拍,掌击\r\n
slaughter	/'slɔ:tə/	n.屠杀,屠宰vt.屠杀,宰杀\r\n
slave	/sleiv/	n.奴隶,苦工v.做苦工,拼命地干\r\n
sleep	/sli:p/	v.(slept,slept)睡n.睡眠\r\n
sleeve	/sli:v/	n.袖子\r\n
slender	/'slendə/	a.修长的,细长的,苗条的;微小的,微薄的\r\n
slice	/slais/	n.薄片,切片;一份;部分切(片)\r\n
slide	/slaid/	v.(使)滑动n.滑坡,滑道;滑,滑动;幻灯片\r\n
slight	/slait/	a.轻微的,微小的;纤细的,瘦弱的\r\n
slim	/slim/	a.苗条的;(机会)少的v.减轻体重,变苗条\r\n
slip	/slip/	v.滑,滑倒;滑掉;溜走n.疏忽,小错,口误,笔误\r\n
slipper	/'slipə/	n.便鞋,拖鞋\r\n
slippery	/'slipəri/	a.滑的,滑溜的\r\n
slit	/slit/	v.切开,截开,纵割n.细长裂缝,狭长切口\r\n
slogan	/'sləuɡən/	n.标语,口号\r\n
slope	/sləup/	n.斜坡,斜面;倾斜,斜度v.(使)倾斜\r\n
slot	/slɔt/	n.狭缝;空位vt.放入狭缝中;把…纳入\r\n
slow	/sləu/	a.慢的,不活跃的v.(down)(使)放慢,减速\r\n
slum	/slʌm/	n.贫民窟,贫民区,陋巷\r\n
sly	/slai/	a.狡猾的,偷偷摸摸的\r\n
small	/smɔ:l/	a.小的;年幼的;不重要的;小规模(经营)的\r\n
smart	/smɑ:t/	a.漂亮的;聪明的;巧妙的v.剧痛,刺疼\r\n
smash	/smæʃ/	v./n.打碎,粉碎\r\n
smell	/smel/	n.气味;嗅觉v.嗅,闻到;散发(…的)气味\r\n
smile	/smail/	n.微笑,笑容vi.微笑,露出笑容\r\n
smog	/smɔɡ,smɔ:ɡ/	n.烟雾\r\n
smoke	/sməuk/	n.烟,烟尘;吸烟,抽烟v.抽(烟);冒烟,冒气\r\n
smooth	/smu:ð/	a.光滑的;顺利的;柔和的v.(over)掩饰\r\n
smuggle	/'smʌɡl/	v.走私;偷运\r\n
snack	/snæk/	n.快餐,小吃,点心\r\n
snake	/sneik/	n.蛇\r\n
snap	/snæp/	v.啪地移动;(使）突然断开,断开（成两截)\r\n
snatch	/snætʃ/	n./v.攫取,抢夺\r\n
sneak	/sni:k/	vi.偷偷地走,溜vt.偷偷地做(或拿、吃)\r\n
sneeze	/sni:z/	vi.打喷嚏,发喷嚏声n.喷嚏\r\n
sniff	/snif/	vi.嗅…味道;抽鼻涕;对嗤之以鼻,蔑视\r\n
snow	/snəu/	n.雪,下雪vi.下雪;如雪一般地落下\r\n
snowstorm	/'snəustɔ:m/	n.暴风雪\r\n
so	/'səu,弱sə/	ad.那么;非常;也;不错conj.因此;以便\r\n
soak	/səuk/	v.浸泡,浸湿,浸透\r\n
soap	/səup/	n.肥皂\r\n
soar	/sɔ:/	vi.(指鸟等)高飞,翱翔;飞涨;高耸\r\n
sob	/,səu'bi:/	v./n.哭泣,呜咽\r\n
sober	/'səubə/	a.清醒的;认真的,冷静的,适度的\r\n
so-called	/'səu'kɔ:ld/	a.(贬)所谓的,号称的\r\n
soccer	/'sɔkə/	n.足球\r\n
sociable	/'səuʃəbl/	a.好交际的,友好的,合群的\r\n
social	/'səuʃəl/	a.社会的;交际的\r\n
socialism	/'səuʃəlizəm/	n.社会主义\r\n
society	/sə'saiəti/	n.社会;社团,协会,社;社交界,上流社会\r\n
sociology	/,səusi'ɔlədʒi,-ʃi-/	n.社会学\r\n
sock	/sɔk/	n.(pl.)短袜\r\n
soda	/'səudə/	n.苏打,汽水\r\n
sofa	/'səufə/	n.长沙发,沙发\r\n
soft	/sɔft,sɔ:ft/	a.软的;温柔的;细嫩的,光滑的;不含酒精的\r\n
software	/'sɔftwεə,'sɔ:-/	n.软件\r\n
soil	/sɔil/	n.泥土,土地,土壤v.弄脏,(使)变脏\r\n
solar	/'səulə/	a.太阳的,日光的\r\n
soldier	/'səuldʒə/	n.士兵,军人\r\n
sole	/səul/	a.单独的,唯一的n.脚垫,鞋底\r\n
solemn	/'sɔləm/	a.庄严的,隆重的;严肃的\r\n
solid	/'sɔlid/	a.固体的;结实的,稳固的,可靠的n.固体\r\n
solidarity	/,sɔli'dæriti/	n.团结;休戚相关\r\n
solitary	/'sɔlitəri/	a.(好)孤独的;偏僻的;单一的,唯一的\r\n
solo	/'səuləu/	n.独奏a.&ad.单独的(地);独唱的(地)\r\n
soluble	/'sɔljubl/	a.可溶的\r\n
solution	/sə'lju:ʃən/	n.解答,解决办法;溶解,溶液\r\n
solve	/sɔlv,sɔ:lv/	v.解决,解答\r\n
some	/sʌm,弱səm,sm/	a.几个;一些;有些;某(人或物)pron.一些\r\n
somebody	/'sʌm,bɔdi,-bʌ-/	pron.某人,有人n.重要人物\r\n
somehow	/'sʌmhau/	ad.以某种方式,用某种方法;不知怎么地\r\n
someone	/'sʌm,wʌn,-wən/	pron.某人(=somebody)\r\n
something	/'sʌmθiŋ/	pron.某事,某物;被视为有意义的事物\r\n
sometime	/'sʌmtaim/	ad.将来(或过去)某个时候a.以前的\r\n
sometimes	/'sʌmtaimz/	ad.不时,有时,间或\r\n
somewhat	/'sʌmhwɔt,-hwət/	pron.&ad.一点儿,几分\r\n
somewhere	/'sʌmhwεə/	ad.某地,在某处;在附近,前后,大约\r\n
son	/sʌn/	n.儿子;孩子(长者对年青或年幼男子的称呼)\r\n
song	/sɔŋ,sɔ:ŋ/	n.歌唱,(虫、鸟等)鸣声;歌曲,歌词\r\n
soon	/su:n/	ad.不久,即刻;快,早\r\n
sophisticated	/sə'fistikeitid/	a.尖端的,复杂的,先进的;老练的,老于世故的\r\n
sophomore	/ˈsɒfəmɔː(r)/	(中学、大学)二年级学生\r\n
sore	/sɔ:/	a.疼痛的;痛心的n.痛处,疮口\r\n
sorrow	/'sɔrəu,'sɔ:-/	n.悲衰,悲痛\r\n
sorry	/'sɔ:ri,'sɔ-/	a.对不起,抱歉的;难过,悔恨的;使人伤心\r\n
sort	/sɔ:t/	n.种类,类别v.分类,整理\r\n
soul	/səul/	n.灵魂,心灵;精神,精力;人\r\n
sound	/saund/	n.声音v.发声,响a.健全的,完好的;正当的\r\n
soup	/su:p/	n.汤\r\n
sour	/'sauə/	a.酸的;发酸的;酸痛的;脾气坏的;刻薄的\r\n
source	/sɔ:s/	n.源,源泉;来源,出处\r\n
south	/sauθ,sauð/	n.南,南方,南部a.南方的,南部的\r\n
southeast	/,sauθ'i:st/	n./a.东南(的),东南部(的)\r\n
southern	/'sʌðən/	a.南方的,南部的\r\n
southwest	/,sauθ'west/	n./a.西南(的),西南部(的)\r\n
sovereign	/'sɔvərin,'sʌv-/	a.独立的,有主权的n.君主,国王,统治者\r\n
sow	/səu/	v.播种\r\n
space	/speis/	n.间隔;空地,余地;空间v.留间隔,隔开\r\n
spacecraft	/'speiskrɑ:ft,-kræft/	n.宇宙飞船\r\n
spaceship	/'speisʃip/	n.宇宙飞船\r\n
spacious	/'speiʃəs/	adj.广阔的,宽敞的\r\n
spade	/'speid/	n.铁锹,铲子\r\n
span	/spæn/	n.跨度,跨距\r\n
spare	/spεə/	a.多余的,备用的v.节约,节省;抽出(时间)\r\n
spark	/spɑ:k/	n.火花,火星v.发火花,发电花\r\n
sparkle	/'spɑ:kl/	v.发火花,闪耀\r\n
speak	/spi:k/	v.说话,讲话;演说,发言;(in)说某种语言\r\n
speaker	/'spi:kə/	n.说话者,发言者;说某种语言者;扬声器\r\n
spear	/spiə/	n.矛,枪\r\n
special	/'speʃəl/	a.特殊的,专门的;附加的,额外的\r\n
specialist	/'speʃəlist/	n.专家\r\n
speciality	/,speʃi'æləti/	n.(specialty)特性,性质;专业/长;特产\r\n
specialize	/'speʃəlaiz/	v.(specialise)(in)专攻,专门研究,专业化\r\n
species	/'spi:ʃi:z,-si:z/	n.(物)种,种类\r\n
specific	/spi'sifik/	a.明确的,具体的;特定的,特有的\r\n
specification	/,spesifi'keiʃən/	n.详述;(常pl.)规格,说明书,规范\r\n
specify	/'spesəfai,-si-/	v.指定,详细说明\r\n
specimen	/'spesimin,-əmən/	n.标本,样本\r\n
spectacle	/'spektəkl/	n.(pl.)眼镜;场面,景象;奇观,壮观\r\n
spectacular	/spek'tækjulə/	a.壮观的,引人注目的n.壮观的演出\r\n
spectator	/spek'teitə,'spekt-/	n.观众,旁观者\r\n
spectrum	/'spektrəm/	n.谱,光谱,频谱;范围,幅度,系列\r\n
speculate	/'spekjuleit/	vi.思索;推测vt.投机;思索,推测\r\n
speech	/spi:tʃ/	n.演说,讲话;言语,语言\r\n
speed	/spi:d/	n.速度,快v.迅速,前进,急行;加速,使加速\r\n
spell	/spel/	v.拼写\r\n
spelling	/'speliŋ/	n.拼法,拼写法\r\n
spend	/spend/	v.花费;消耗,用尽;度过,消磨\r\n
sphere	/sfiə/	n.球,球体;范围,领域\r\n
spicy	/'spaisi/	a.加很多香料的;(口味)浓郁的\r\n
spider	/'spaidə/	n.蜘蛛\r\n
spill	/spil/	v.溢出,溅出n.摔下,跌下\r\n
spin	/spin/	v.旋转;纺纱;织网,吐丝n.旋转;自转\r\n
spine	/spain/	n.脊柱,脊椎;(动植物的)刺;书脊\r\n
spiral	/'spaiərəl/	a.螺旋形的n.螺旋,螺线v.螺旋上升;盘旋\r\n
spirit	/'spirit/	n.精神;志气;(pl.)情绪,心情;(pl.)酒精\r\n
spiritual	/'spiritjuəl,-tʃuəl/	a.精神(上)的,心灵的\r\n
spit	/spit/	v.吐(唾沫),吐痰n.唾液\r\n
spite	/spait/	n.恶意;怨恨\r\n
splash	/splæʃ/	v.溅,泼n.溅,飞溅声\r\n
splendid	/'splendid/	a.壮丽的,辉煌的;极好的\r\n
split	/split/	v.裂开,劈开;分裂,分离n.分化,分裂,裂口\r\n
spoil	/spɔil/	v.损坏,搞错;宠坏,溺爱\r\n
spokesman	/'spəuksmən/	n.发言人\r\n
sponge	/spʌndʒ/	n.海绵\r\n
sponsor	/'spɔnsə/	n.发起人,主力者,保证人v.发起,主办\r\n
spontaneous	/spɔn'teiniəs/	a.自发的,自然产生的\r\n
spoon	/spu:n/	n.匙,调羹\r\n
sport	/spɔ:t/	n.(体育)运动(pl.)运动会vi.开玩笑;玩耍\r\n
sportsman	/'spɔ:tsmən/	n.爱好运动的人;运动员\r\n
spot	/spɔt/	n.斑点;地点v.认出,认清,发现;玷污,弄脏\r\n
spouse	/spaus/	n.配偶(指夫或妻)\r\n
spray	/sprei/	n.喷雾,飞沫,浪花,水花v.喷,喷射\r\n
spread	/spred/	v./n.伸开,伸展;散布,传播\r\n
spring	/spriŋ/	n.春;跳;泉,源泉;弹簧,发条v.跳,跳跃\r\n
sprinkle	/'spriŋkl/	n.洒,喷,淋\r\n
sprout	/spraut/	vi.发芽,抽条vt.使发芽n.新芽,嫩苗\r\n
spur	/spə:/	n.靴刺,马刺;刺激,刺激物v.刺激,激励\r\n
spy	/spai/	n.间谍v.当间谍,刺探;察觉,发现\r\n
square	/skwεə/	n.正方形;广场a.正方形的v.使成方形\r\n
squeeze	/skwi:z/	v.压榨,挤n.榨取,勒索\r\n
squirrel	/'skwə:rəl/	n.松鼠\r\n
stab	/stæb/	v./n.刺,戳\r\n
stability	/stə'biliti/	n.稳定,安定\r\n
stable	/'steibl/	a.稳定的,安定的n.马厩,马棚\r\n
stack	/stæk/	n.堆,一堆v.堆积,堆起\r\n
stadium	/'steidiəm/	n.体育场\r\n
staff	/stɑ:f,stæf/	n.全体职工;杠,棒;参谋部v.配备工作人员\r\n
stage	/steidʒ/	n.舞台,戏剧;阶段,时期\r\n
stagger	/'stæɡə/	vi.摇晃着移动;蹒跚n.摇晃不稳的动作;蹒跚\r\n
stain	/stein/	n.污点,瑕疵v.沾污;染色\r\n
stair	/stεə/	n.(pl.)楼梯\r\n
staircase	/'stεəkeis/	n.(stairway)楼梯\r\n
stake	/steik/	n.桩,标桩;赌注,利害关系\r\n
stale	/steil/	n.变质的,不新鲜的;陈旧的,陈腐的\r\n
stalk	/stɔ:k/	n.茎,梗vt.悄悄地跟踪vi.高视阔步地走\r\n
stall	/stɔ:l/	n.货摊;畜栏,厩v.(使)停转,(使)停止\r\n
stamp	/stæmp/	n.邮票;印;跺脚;标志v.跺脚,顿足;盖章\r\n
stand	/stænd/	vi.站立;位于;经受n.台,座;货摊;立场\r\n
standard	/'stændəd/	n.标准,规则a.标准的\r\n
standpoint	/'stændpɔint/	n.立场,观点\r\n
staple	/'steipl/	n.主要产品;名产;纤维;主要成分,主食\r\n
star	/stɑ:/	n.星;恒星;明星v.用星号标出;扮演主角\r\n
stare	/stεə/	v.(at)盯,凝视\r\n
start	/stɑ:t/	v.开始;动身;吃惊;开办,开动n.开端;惊起\r\n
startle	/'stɑ:tl/	v.惊吓,使吃惊\r\n
starve	/stɑ:v/	v.(使)饿死,饿得慌,挨饿\r\n
state	/steit/	n.状态,情况;国,州v.陈述,说明\r\n
statement	/'steitmənt/	n.声明,陈述\r\n
statesman	/'steitsmən/	n.政治家,国务活动家\r\n
static	/'stætik/	a.(statical)静态的,静力的\r\n
station	/'steiʃən/	n.车站;所,站,局;身份,地位v.安置,驻扎\r\n
stationary	/'steiʃənəri/	a.静止的,固定的\r\n
stationery	/'steiʃənəri/	n.文具\r\n
statistical	/stə'tistikəl/	a.统计的,统计学的\r\n
statue	/'stætju:,-tʃu/	n.塑像,雕像\r\n
status	/'steitəs,'stæ-/	n.地位,身份;情形,状况\r\n
statute	/'stætju:t,-tʃu:t/	n.成文法,法令,法规;章程,规则,条例\r\n
stay	/stei/	vi.逗留;保持vt.停止,延缓n.逗留,停留\r\n
steady	/'stedi/	a.稳定的,不变的;坚定的v.(使)稳固/稳定\r\n
steak	/steik/	n.牛排;大块肉(或鱼)片\r\n
steal	/sti:l/	v.偷,窃取;偷偷地做,巧取\r\n
steam	/sti:m/	n.水汽,蒸汽,水蒸气v.蒸发;蒸;用蒸汽开动\r\n
steamer	/'sti:mə/	n.汽船,轮船\r\n
steel	/sti:l/	n.钢\r\n
steep	/sti:p/	a.陡峭的;险峻的;急剧升降的vt.浸泡,沉浸\r\n
steer	/stiə/	vt.驾驶,为…操舵;引导vi.驾驶\r\n
stem	/stem/	n.茎,干vt.堵(挡)住vi.起源于,由…造成\r\n
step	/step/	n.步;台阶,梯级;步骤,措施v.踏,走,举步\r\n
stereo	/'steri,əu,'stiə-,'sti:-/	n.立体声音响;立体声装置n./a.立体声(的)\r\n
stereotype	/'steriəutaip,'stiə-/	n.陈规,老套,模式化vt.使定型,使模式化\r\n
stern	/stə:n/	a.严厉的;坚决的,坚定的n.船尾,舟尾\r\n
steward	/'stju:əd,'stjuəd/	n.乘务员,服务员;看管人;膳食管理员\r\n
stick	/stik/	n.棍,棒,手杖v.刺,戳,扎;粘贴\r\n
sticky	/'stiki/	a.粘的,粘性的;棘手的;(道路)泥泞的\r\n
stiff	/stif/	a.硬的,僵直的;拘谨的;呆板的;艰难的\r\n
still	/stil/	a.静止的,寂静的ad.还,仍然;更;安静地\r\n
stimulate	/'stimjuleit/	v.刺激,使兴奋;激励,鼓舞\r\n
sting	/stiŋ/	v./n.刺,刺痛,剧痛;刺,叮\r\n
stir	/stə:/	v.搅拌,搅动;动,摇动;激动;轰动;煽动,鼓动\r\n
stitch	/stitʃ/	n.一针;(因跑步引起的)肋部剧痛v.缝(合)\r\n
stock	/stɔk/	n.备料,库存,现货;股票,公债v.储存\r\n
stocking	/'stɔkiŋ/	n.长(统)袜\r\n
stomach	/'stʌmək/	n.胃,胃口;肚子,腹部vt.承受,忍受\r\n
stone	/stəun/	n.石,石头;岩石,矿石;(水果的)核、子\r\n
stool	/stu:l/	n.凳子;(pl.)大便\r\n
stoop	/stu:p/	v.弯腰,俯身n.弯腰,曲背\r\n
stop	/stɔp/	v.停止;塞住;阻止,阻挠;逗留n.停车站;停止\r\n
storage	/'stɔridʒ/	n.贮藏(量),保管;库房\r\n
store	/stɔ:/	n.商店,店铺;贮藏,贮备品v.贮藏,贮备\r\n
storey	/'stɔ:ri/	n.(story)楼,层\r\n
storm	/stɔ:m/	n.暴风雨,暴风雪;激动,爆发v.猛攻,直捣\r\n
story	/'stɔ:ri/	n.故事,传说,小说;(=storey)楼层\r\n
stove	/stəuv/	n.炉子,火炉\r\n
straight	/streit/	a.直的;整齐的,端正的ad.直接;正直,直率\r\n
straightforward	/,streit'fɔ:wəd/	a.正直的;简单的,易懂的ad.坦率地\r\n
strain	/strein/	v.拉紧;紧张;扭伤;竭尽全力n.拉紧;负担\r\n
strange	/streindʒ/	a.奇怪的,奇异的;陌生的,生疏的;外地的\r\n
stranger	/'streidʒə/	n.陌生人,生客;外地人,外国人\r\n
strap	/stræp/	n.皮带,带子v.用带扣住,束牢;用绷带包扎\r\n
strategy	/'strætidʒi/	n.战略,策略;对策,政策\r\n
straw	/strɔ:/	n.稻草,麦杆;吸管\r\n
strawberry	/'strɔ:bəri/	n.草莓\r\n
stream	/stri:m/	n.小河,溪流;流,一股,一串v.流出,涌\r\n
streamline	/'stri:mlain/	a.流线型的vt.使成流线型;使合理化\r\n
street	/stri:t/	n.街,街道;行车道\r\n
strength	/streŋθ,streŋkθ/	n.力,力量;实力;长处,优点;人力;兵力\r\n
strengthen	/'streŋθən,'streŋkθən/	v.加强,巩固\r\n
strenuous	/'strenjuəs/	a.费力的,艰辛的;奋发的,努力的\r\n
stress	/stres/	n.压力;重要性;应力;重音vt.强调,重读\r\n
stretch	/stretʃ/	v.伸展,延伸n.拉长;伸展;一段时间/路程\r\n
strict	/strikt/	a.(with)严格的,严厉的;严谨的,精确的\r\n
stride	/straid/	vi.大踏步走;跨越n.一大步(pl.)长足进步\r\n
strife	/straif/	n.争吵;冲突,斗争;竞争\r\n
strike	/straik/	n./vi.罢工vt.打,击;攻击;给…深刻印象\r\n
striking	/'straikiŋ/	a.显著的;惹人注目的,容貌出众的\r\n
string	/striŋ/	n.弦,线,细绳;(一串),(一行)v.缚,捆\r\n
strip	/strip/	v.剥,剥去n.窄条,条纹\r\n
stripe	/straip/	n.长条,条纹;军服上表示军阶的臂章条纹\r\n
strive	/straiv/	v.奋斗,努力\r\n
stroke	/strəuk/	n.击;报时的钟声;一击/划/笔;中风v.抚摸\r\n
stroll	/strəul/	n.&v.漫步;散步;游荡\r\n
strong	/strɔŋ,strɔ:ŋ/	a.强壮的,强大的;强烈的,浓的\r\n
structure	/'strʌktʃə/	n.结构,构造;建筑物v.构造,建造\r\n
struggle	/'strʌɡl/	n./v.斗争,奋斗,努力\r\n
stubborn	/'stʌbən/	a.顽固的,倔强的;难对付的,难以克服的\r\n
student	/'stju:dənt,'stu:-/	n.(大中学校的)学生;研究者,学者\r\n
studio	/'stju:diəu,'stu:-/	n.画室;播音室;(电影)制片厂\r\n
study	/'stʌdi/	vt.学习;研究;细看vi.读书n.学习;研究\r\n
stuff	/stʌf/	n.原料,材料,东西v.填满,塞满\r\n
stumble	/'stʌmbl/	n.跌倒,绊倒vi.绊(摔)倒;结结巴巴说\r\n
stun	/stʌn/	vt.使…失去知觉;使目瞪口呆,使吃惊\r\n
stupid	/'stju:pid,'stu:-/	a.愚蠢的,迟钝的\r\n
sturdy	/'stə:di/	a.坚定的,不屈不挠的;强健的,结实的\r\n
style	/stail/	n.风格,文体;式样,时式,类型\r\n
subject	/'sʌbdʒikt,səb'dʒekt/	n.主题;学科a.隶属的;易遭..的v.使隶属\r\n
subjective	/səb'dʒektiv/	a.主观(上)的,个人的\r\n
submarine	/'sʌbməri:n/	n.潜水艇a.水底的,海底的\r\n
submerge	/səb'mə:dʒ/	v.沉没,淹没;潜入\r\n
submit	/səb'mit/	v.(to)使服从,屈服;(to)呈送,提交\r\n
subordinate	/sə'bɔ:dinət,-neit/	a.(to)次要的,从属的;下级的\r\n
subscribe	/səb'skraib/	vi.(to)订阅,订购;同意vt.捐助,赞助\r\n
subsequent	/'sʌbsikwənt/	a.随后的,后来的\r\n
subsidy	/'sʌbsidi/	n.补助金;津贴费\r\n
substance	/'sʌbstəns/	n.物质;实质,本质;主旨;财产,资产\r\n
substantial	/səb'stænʃəl/	a.实质的;相当的;显著的;坚固的;富裕的\r\n
substitute	/'sʌbstitju:t,-tu:t/	n.代替者;替身;代用品v.(for)代替,替换\r\n
subtle	/'sʌtl/	a.精巧的,巧妙的;细微的,微妙的\r\n
subtract	/səb'trækt/	v.(from)减(去),扣掉\r\n
suburb	/'sʌbə:b/	n.市郊,郊区\r\n
subway	/'sʌbwei/	n.地铁;地下行人隧道\r\n
succeed	/sək'si:d/	vi.成功;继承,接替vt.接替;继…之后\r\n
success	/sək'ses/	n.成就,成功;成功的事物,有成就的人\r\n
successful	/sək'sesful/	a.圆满的;顺利的;成功的\r\n
succession	/sək'seʃən/	n.连续,系列;继任,继承\r\n
successive	/sək'sesiv/	a.接连的,连续的\r\n
successor	/sək'sesə/	n.接替的人或事物,继任者\r\n
such	/sʌtʃ,sətʃ/	a.这样的;上述的ad.那么pron.这样的人/事物\r\n
suck	/sʌk/	v.&n.吸,舐;吸收(取)\r\n
sudden	/'sʌdən/	a.出乎意料的,突然的\r\n
sue	/sju:,su:/	v.控告,对…提出诉讼,起诉\r\n
suffer	/'sʌfə/	v.(from)受痛苦,患病;受损失;遭受;忍受\r\n
suffice	/sə'fais/	v.充足,足够;vt.(食物等)使(某人)满足\r\n
sufficient	/sə'fiʃənt/	a.(for)足够的,充分的(比enough拘谨、正式)\r\n
sugar	/'ʃuɡə/	n.糖,食糖vt.加糖于\r\n
suggest	/sə'dʒest,səɡ-/	v.建议,提出;使联想,使想起…;暗示\r\n
suggestion	/səɡ'dʒestʃən/	n.建议,意见;细微的迹象;暗示,联想\r\n
suicide	/'sjuisaid/	n.自杀;给自己带来恶劣后果的行为\r\n
suit	/sju:t,su:t/	v.合适,适合;相配,适应n.一套西服;诉讼\r\n
suitable	/'sju:təbl/	a.(for)合适的,适宜的\r\n
suite	/swi:t/	n.套间;一套家具;套,组,系列\r\n
sulfur	/'sʌlfə/	n.(sulphur)硫\r\n
sum	/sʌm/	n.总数,和;金额;算术题;要旨v.合计,总计\r\n
summarize	/'sʌməraiz/	v.(summarise)概括,总结\r\n
summary	/'sʌməri/	n.摘要,概要a.概括的,简略的\r\n
summer	/'sʌmə/	n.夏天,夏季a.夏季的\r\n
summit	/'sʌmit/	n.顶,最高点;颠峰,高峰;最高级会议\r\n
summon	/'sʌmən/	v.召唤;传讯,传唤;鼓起(勇气),振作(精神)\r\n
sun	/sʌn/	n.太阳;恒星;美国Sun公司\r\n
Sunday	/ˈsʌndeɪ/	n.星期日\r\n
sunrise	/'sʌnraiz/	n.日出,拂晓;朝霞\r\n
sunset	/'sʌnset/	n.日落,傍晚;晚霞\r\n
sunshine	/'sʌnʃain/	n.日光,日照;晴天;\r\n
super	/'sju:pə/	a.极好的,超级的\r\n
superb	/sju'pə:b,sə-/	a.极好的,杰出的;华丽的;\r\n
superficial	/,sju:pə'fiʃəl/	a.表面的;肤浅的,浅薄的\r\n
superfluous	/sju'pə:fluəs/	a.多余的,过剩的,\r\n
superior	/sju:'piriə,sju:pə-/	a.优良的,卓越的;上级的n.上级;长者;高手\r\n
superiority	/sju:,piəri'ɔriti,sə-/	n.优越(性),优势,优等;高傲,傲慢\r\n
supermarket	/'sju:pə,mɑ:kit/	n.超级市场\r\n
supersonic	/,sju:pə'sɔnik/	a.超音速的,超声波的n.超声波,超声频\r\n
superstition	/,sju:pə'stiʃən/	n.迷信,迷信的观念习俗\r\n
supervise	/'sju:pəvaiz/	v.管理,监督\r\n
supper	/'sʌpə/	n.晚餐\r\n
supplement	/'sʌplimənt/	n.补遗;增刊;附录v.增刊,补充\r\n
supply	/sə'plai/	v.(with,to)供给,供应,补足n.供应,供应量\r\n
support	/sə'pɔ:t/	n./vt.支撑;支持;赡养;维持n.支持者;支柱\r\n
suppose	/sə'pəuz/	v.料想,猜想;假定;conj.假使...结果会怎样\r\n
suppress	/sə'pres/	v.镇压,压制;抑制,忍住;查禁\r\n
supreme	/sju'pri:m,sə-/	a.极度的,最重要的;至高的,最高的\r\n
sure	/ʃuə,ʃɔ:/	a.肯定的;一定会…的;有信心的,有把握的\r\n
surface	/'sə:fis/	n.表面;外表a.表面的,肤浅的\r\n
surge	/sə:dʒ/	vi.汹涌;彭湃;蜂拥而至n.巨浪;汹涌;彭湃\r\n
surgeon	/'sə:dʒən/	n.外科医生\r\n
surgery	/'sə:dʒəri/	n.外科,外科学;手术室,诊疗室\r\n
surname	/'sə:neim/	n.姓\r\n
surpass	/sə'pɑ:s,-'pæs/	vt.超过,胜过\r\n
surplus	/'sə:plʌs,-pləs/	n.过剩,剩余;余款,余额a.过剩的,剩余的\r\n
surprise	/sə'praiz/	v.使诧异,使惊异;奇袭n.诧异,惊异;奇袭\r\n
surrender	/sə'rendə/	vi.投降,屈服vt.放弃,交出n.投降,认输\r\n
surround	/sə'raund/	vt.包围,环绕n.环绕物\r\n
surroundings	/səˈraʊndɪŋz/	n.周围的事物,环境\r\n
survey	/sə:'vei,'sə:vei,sə-/	v./n.俯瞰,眺望;全面审视,调查;测量图,勘定\r\n
survival	/sə'vaivəl/	n.幸存,生存;幸存者,残存物\r\n
survive	/sə'vaiv/	v.幸免于,幸存;比…长命\r\n
susceptible	/sə'septəbl/	a.易受影响的;易受感动的;易受感染的\r\n
suspect	/sə'spekt,'sʌspekt/	v.猜想;怀疑;察觉a.可疑的n.嫌疑犯\r\n
suspend	/sə'spend/	v.悬(浮),挂;暂停,取消;推迟\r\n
suspicion	/sə'spiʃən/	n.怀疑,猜疑;一点儿,少量\r\n
suspicious	/sə'spiʃəs/	a.(of)可疑的,多疑的,疑心的\r\n
sustain	/sə'stein/	vt.支撑,撑住;维持,持续,经受,忍耐\r\n
swallow	/'swɔləu/	n.燕子;吞咽vt.吞,咽;轻信;忍受;vi.咽口水\r\n
swamp	/swɔmp,swɔ:mp/	n.沼泽;湿地vt.浸没;使…应接不暇\r\n
swan	/swɔn,swɔ:n/	n.天鹅vi.闲荡,游荡\r\n
swarm	/swɔ:m/	n.蜂群;一大群vi.涌往;挤满;云集;成群移动\r\n
sway	/swei/	vi.摇动;倾斜vt.使摇动n.摇动;影响力\r\n
swear	/swεə/	v.(at)诅咒,骂人;宣誓,发誓\r\n
sweat	/swet/	n.汗v.(使)出汗\r\n
sweater	/'swetə/	n.毛衣,绒衣,厚运动衫\r\n
sweep	/swi:p/	v.扫,打扫;席卷,冲光;扫过,掠过\r\n
sweet	/swi:t/	a.甜的;可爱的,美好的n.(常pl.)糖果;甜食\r\n
swell	/swel/	n./v.肿胀;膨胀;增大;增加;\r\n
swift	/swift/	a./ad.快的(地);敏捷的(地)a.立刻的n.雨燕\r\n
swim	/swim/	vi.游泳;游;漂浮;眩晕;充溢vt.游过n.游泳\r\n
swing	/swiŋ/	v.摇摆,摇荡,回转,旋转n.秋千;摇摆,摆动\r\n
switch	/switʃ/	n.开关;转换;鞭子v.转变,转换;抽打\r\n
sword	/sɔ:d/	n.剑,刀;武力\r\n
symbol	/'simbəl/	n.符号,标志;象征\r\n
symmetry	/'simitri/	n.对称(性);匀称,整齐\r\n
sympathetic	/,simpə'θetik/	a.有同情心的;赞同的;n.交感神经\r\n
sympathize	/'simpəθaiz/	v.(sympathise)(with)同情;共鸣,同感;赞成\r\n
sympathy	/'simpəθi/	n.同情,同情心;赞同,同感;慰问\r\n
symphony	/'simfəni/	n.交响乐,交响曲\r\n
symposium	/sim'pəuziəm/	n.讨论会,专题报告会;专题论文集\r\n
symptom	/'simptəm/	n.(疾病的)症状;(不好事情的)征兆,表征\r\n
syndrome	/'sindrəum,-drəm-/	n.综合病征;并存特性\r\n
synthesis	/'sinθisis/	n.(pl.syntheses)综合,合成\r\n
synthetic	/sin'θetik/	a.合成的,人造的;综合的\r\n
system	/'sistəm/	n.系统,体系;制度;方法,方式,步聚\r\n
systematic	/,sisti'mætik/	a.(systematical)系统的,有组织的\r\n
table	/'teibl/	n.桌子;餐桌;工作台;表格vt.搁置;提交讨论\r\n
tablet	/'tæblit/	n.药片;碑,匾\r\n
tackle	/'tækl/	n.滑车;用具,器械v.处理,解决;抱住,抓住\r\n
tactic	/'tæktik/	n.(tactics)策略,战术\r\n
tag	/tæɡ/	n.标签;鞋带;垂饰;vt.加标签于;附加vi.紧随\r\n
tail	/teil/	n.尾巴;尾部;跟踪者vt.尾随,跟踪\r\n
tailor	/'teilə/	n.裁缝v.缝制,剪裁\r\n
take	/teik/	v.拿取;吃;记录;取得;花费;捕获;认为\r\n
tale	/teil/	n.故事,传说\r\n
talent	/'tælənt/	n.才能,天资;人才\r\n
talk	/tɔ:k/	n.谈话;聊天;讲话;演讲v.说话;交谈\r\n
tall	/tɔ:l/	a.(身材)高的,高大的;夸大的,离谱的\r\n
tame	/teim/	a.驯服的,温顺的;沉闷的,乏味的vt.驯服\r\n
tan	/tæn/	n./a.(皮肤因日晒而成)棕褐色(的)vt.晒黑\r\n
tangle	/'tæŋɡl/	n.纠缠;缠结;混乱v.(使)缠绕;变乱\r\n
tank	/tæŋk/	n.罐,槽,箱;坦克vt.储于槽中\r\n
tanker	/'tæŋkə/	n.油船\r\n
tap	/tæp/	n.塞子;水龙头;n./v.轻打,轻敲;vt.开发\r\n
tape	/teip/	n.带(子);录音带,磁带v.录音;系,捆\r\n
tar	/tɑ:/	n.柏油,焦油vt.涂或浇柏油/焦油于\r\n
target	/'tɑ:ɡit/	n.目标,对象,靶子\r\n
tariff	/'tærif/	n.关税,税率;(旅馆,饭店等)价目表,收费表\r\n
task	/tɑ:sk,tæsk/	n.任务,作业,工作\r\n
taste	/teist/	v.品尝;(of)有…味道;体验n.滋味;味觉\r\n
tax	/tæks/	n.税(款),负担v.对…征税,使负重担\r\n
taxi	/'tæksi/	n.出租汽车v./指飞机/(使)滑行\r\n
tea	/ti:/	n.茶(叶);午后茶点\r\n
teach	/ti:tʃ/	vt.教,讲授;教导(训)vi.讲课,当教师\r\n
teacher	/'ti:tʃə/	n.教师(员),老(导)师\r\n
team	/ti:m/	n.小队,小组v.协同工作\r\n
tear	/tiə/	n.(pl.)眼泪vt.撕裂;使…分裂vi.破裂\r\n
tease	/ti:z/	v.戏弄,取笑;挑逗n.(爱)戏弄他人者;戏弄\r\n
technical	/'teknikəl/	a.技术(性)的,工艺的;专门性的,专业性的\r\n
technician	/tek'niʃən/	n.技术员,技师,技工\r\n
technique	/tek'ni:k/	n.技巧,手艺,技能;技术,工艺\r\n
technology	/tek'nɔlədʒi/	n.科学技术;工业技术;应用科学\r\n
tedious	/'ti:diəs,'ti:dʒəs/	a.乏味的,单调的,冗长的\r\n
teenager	/'ti:n,eidʒə/	n.十几岁的青少年\r\n
telegram	/'teliɡræm/	n.电报\r\n
telegraph	/'teliɡrɑ:f,-ɡræf/	n.电报机,电报v.打电报,发电报\r\n
telephone	/'telifəun/	n.电话,电话机v.打电话\r\n
telescope	/'teliskəup/	n.望远镜v.缩短,压缩\r\n
tell	/tel/	vt.告诉,讲述;告诫;吩咐,命令;辨/区别\r\n
temper	/'tempə/	n.脾气;韧度vt.调和,使缓和;使回火\r\n
temperament	/ˈtemprəmənt/	n.气质,性格,性情;资质\r\n
temperature	/'tempəritʃə/	n.温度,体温;热度,发烧\r\n
temple	/'templ/	n.庙宇,神殿,寺;太阳穴\r\n
tempo	/'tempəu/	n.节奏,行进速度;(音乐的)速度\r\n
temporary	/'tempərəri/	a.暂时的,临时的\r\n
tempt	/tempt/	v.诱惑,引诱;吸引,使感兴趣\r\n
temptation	/temp'teiʃən/	n.引诱,诱惑;诱惑物\r\n
ten	/ten/	num.十pron./a.十(个,只...)\r\n
tenant	/'tenənt/	n.承租人;房客;佃户vt.租借,承租\r\n
tend	/tend/	v.趋向,往往是;照料,看护\r\n
tendency	/'tendənsi/	n.趋势,趋向;倾向\r\n
tender	/'tendə/	a.嫩的;敏感的;温柔的v.提出,提供;投标\r\n
tennis	/'tenis/	n.网球\r\n
tense	/tens/	n.时态v.拉紧,(使)紧张a.绷紧的,紧张的\r\n
tension	/'tenʃən/	n.(紧张)状态;拉(绷)紧;张力,拉力\r\n
tent	/tent/	n.帐篷\r\n
tentative	/'tentətiv/	a.试探性的,暂时的;犹豫不决的\r\n
term	/tə:m/	n.学期;期限,期间;(pl.)条件,条款;术语\r\n
terminal	/'tə:minəl/	a.晚期的;终点的;期末的n.终点(站);终端\r\n
terminate	/'tə:mineit/	vi.(使)结束,(使)停止\r\n
terrible	/'terəbl/	a.很糟的;可怕的,骇人的;极度的,厉害的\r\n
terrific	/tə'rifik/	a.极好的,非常的,极度的\r\n
terrify	/'terifai/	v.使害怕,使惊恐\r\n
territory	/'teritəri/	n.领土;版图;领域,范围\r\n
terror	/'terə/	n.恐怖;可怕的人(事)\r\n
test	/test/	n./vt.试验;检验;测验\r\n
testify	/'testifai/	v.作证,证明;(to)表明,说明\r\n
testimony	/'testiməni/	n.证据,证词;表明,说明\r\n
text	/tekst/	n.正文,文本;原文;教科书\r\n
textbook	/'tekstbuk/	n.课本,教科书\r\n
textile	/'tekstail,-til/	n.纺织品a.纺织的\r\n
texture	/'tekstʃə/	n.(织物)质地;(材料)构造;结构;肌理\r\n
than	/ðæn,弱ðən,ðn/	conj.(用于形容词,副词的比较级之后)比\r\n
thank	/θæŋk/	vt.感谢int./-s/谢谢n./pl./感谢(意)\r\n
Thanksgiving	/ˌθæŋksˈɡɪvɪŋ/	n.感恩节\r\n
that	/ðæt,弱ðət,ðt/	a./pron.那,那个ad.那么conj./引导从句/\r\n
the	/ðə , ði/	art.这(那)个;这(那)些(指特定的人或物)\r\n
theater	/'θiətə,'θi:ə-/	n.(theatre)戏院;戏剧;阶梯教室\r\n
theft	/θeft/	n.偷窃(行为),偷窃罪\r\n
their	/ðεə,弱ðər/	pron../they的所有格/他(她、它)们的\r\n
theirs	/ðεəz/	pron./they的物主代词/他(她、它)们的\r\n
them	/ðem,弱ðəm,ðm/	pron.他们/她们/它们(they的宾格形式)\r\n
theme	/θi:m/	n.题目,主题;主旋律,基调\r\n
themselves	/ðəm'selvz,ðem-/	pron.他(她、它)们自己;他(她、它)们亲自\r\n
then	/ðen/	ad.当时,在那时;然后,于是;那么,因而\r\n
theoretical	/,θiə'retikəl,,θi:ə-/	a.理论(上)的\r\n
theory	/'θiəri,'θi:ə-/	n.理论,原理;学说,见解,看法\r\n
therapy	/'θerəpi/	n.治疗,(不需要药物或手术的)物理疗法\r\n
there	/ðεə,弱ðə,ðr/	ad.在那儿;往那儿;/作引导词表示存在/\r\n
thereafter	/,ðεər'ɑ:ftə,-'æf-/	ad.此后,以后\r\n
thereby	/,ðεə'bai,'ðεəbai/	ad.因此,从而\r\n
therefore	/'ðεəfɔ:/	ad.因此,所以conj.因此\r\n
thermal	/'θə:məl/	a.热的,热力的;(小规模的)上升气流\r\n
thermometer	/θə'mɔmitə/	n.温度计\r\n
these	/ði:z/	pron.&a./this的复数/这些;这些人(东西)\r\n
thesis	/'θi:sis/	n.(pl.theses)论文;论题;论点\r\n
they	/ðei,弱ðe/	商店;(一般人经常用复数they来指一家商店)\r\n
thick	/θik/	a.厚的,粗的,稠的,浓的ad.厚,浓,密\r\n
thief	/θi:f/	n.(thieves)贼;小偷\r\n
thigh	/θai/	n.大腿;股骨\r\n
thin	/θin/	a.薄的,细的;稀薄的,淡的;瘦的v.变薄;变稀\r\n
thing	/θiŋ/	n.物,东西;事,事情;所有物;局面,情况\r\n
think	/θiŋk/	v.想,思索;认为,以为;想要;料想,预料\r\n
third	/θə:d/	num.第三(个),三分之一(的)\r\n
thirst	/θə:st/	n.渴,口渴;(for)渴望,热望\r\n
thirsty	/'θə:sti/	a.口渴的;(for)渴望的,热望的\r\n
thirteen	/'θə:'ti:n/	num./a.十三pron.十三(个,只...)\r\n
thirty	/'θə:ti/	num.三十,三十个(人或物)\r\n
this	/ðis,弱ðəs/	pron.这(个)a.这(个);今ad.这(样)\r\n
thorn	/θɔ:n/	n.刺,荆棘\r\n
thorough	/'θʌrə,'θə:rəu/	a.彻底的,完全的;精心的\r\n
those	/ðəuz/	pron./a./that的复数/那些;那些人(东西)\r\n
though	/ðəu/	ad.可是,然而,不过conj.尽管,虽然\r\n
thought	/θɔ:t/	n.思想,思考,思维;意图,打算;想法\r\n
thoughtful	/'θɔ:tful/	a.认真思考的,沉思的;体贴的,关心的\r\n
thousand	/'θauzənd/	num./n./a.一千;/pl./许许多多,成千上万\r\n
thread	/θred/	n.线,细丝;线索,思路;螺纹v.穿线,穿过\r\n
threat	/θret/	n.恐吓,威胁;坏兆头,危险迹象\r\n
threaten	/'θretən/	v.恐吓,威胁;有…危险,快要来临\r\n
three	/θri:/	num.三pron./a.三(个,只...)\r\n
threshold	/'θreʃhəuld/	n.门槛;入门,开端\r\n
thrift	/θrift/	a.节约,节俭\r\n
thrill	/θril/	n.一阵激动(恐惧)v.激动;(使)毛骨悚然\r\n
thrive	/θraiv/	v.兴旺,繁荣\r\n
throat	/θrəut/	n.咽喉,嗓子\r\n
throne	/θrəun/	n.御座,宝座;王位,王权\r\n
through	/θru:/	prep./ad.穿过;自始至终;由,以a.直达的\r\n
throughout	/θru:'aut/	prep.遍及,贯穿ad.到处,自始至终,彻底\r\n
throw	/θrəu/	vt.扔;使突然陷入;使困惑n.投掷(距离)\r\n
thrust	/θrʌst/	vt.插入;猛推n.插,推力vi.刺,戳,冲\r\n
thumb	/θʌm/	n.拇指v.示意要求搭车;迅速翻阅\r\n
thunder	/'θʌndə/	n.雷(声);轰隆声v.打雷;大声说,吼叫\r\n
Thursday	/ðʌs/	n.星期四\r\n
thus	/ðʌs/	ad.如此;像这样;于是;因此\r\n
tick	/tik/	n.滴答声;勾号v.滴答响;打勾号于\r\n
ticket	/'tikit/	n.票,入场券;票签;(交通违章)罚款传票\r\n
tide	/taid/	n.潮,潮汐;潮流,趋势\r\n
tidy	/'taidi/	a.整洁的,整齐的v.整理,收拾\r\n
tie	/tai/	n.领带;联系,关系,纽带;束缚v.扎,系,捆\r\n
tiger	/'taiɡə/	n．虎;老虎\r\n
tight	/tait/	a.紧的;紧身的,装紧的;密封的ad.紧紧地\r\n
tile	/tail/	n.瓦片,瓷砖vt.铺瓦于,贴砖于\r\n
till	/til/	prep.直到,直到…为止,与until意思相同\r\n
tilt	/tilt/	v.(使)倾侧;(使)倾斜n.倾侧;倾斜\r\n
timber	/'timbə/	n.木材,木料\r\n
time	/taim/	n.时间,时刻;次,回;时代,时期;倍,乘\r\n
timely	/'taimli/	a.及时的,适时的\r\n
timid	/'timid/	a.胆怯的,怯懦的\r\n
tin	/tin/	n.罐头;锡a.锡制的vt.镀锡于\r\n
tiny	/'taini/	a.极小的,微小的\r\n
tip	/tip/	n.尖端;末端;小费n./v.轻击;倾斜;给小费\r\n
tire	/'taiə/	v.(使)疲倦,(使)厌倦n.(=tyre)轮胎,车胎\r\n
tired	/ˈtaɪəd/	a.疲劳的;厌倦的\r\n
tiresome	/'taiəsəm/	a.使人厌倦的,讨厌的\r\n
tissue	/'tiʃju:,-sju:/	n.织物,薄绢,纸巾;(动,植物的)组织\r\n
title	/'taitl/	n.书名,标题;头衔,称号\r\n
to	/tu:,弱tu/	prep.(表示方向)到;向;(表示间接关系)给.\r\n
toast	/'təust/	n.烤面包,吐司;祝酒(词)v.烘,烤;(向…)祝酒\r\n
tobacco	/tə'bækəu/	n.烟草,烟叶\r\n
today	/tə'dei/	ad.在今天;现今,在当代n.今天;现在\r\n
toe	/təu/	n.脚趾,足尖\r\n
together	/tə'ɡeðə/	ad.共同,一起;合起来,集拢地\r\n
toilet	/'tɔilit/	n.厕所,盥洗室\r\n
token	/'təukən/	n.表示;标志;记号;代用硬币a.象征性的\r\n
tolerance	/'tɔlərəns/	n.宽容;容忍,忍受;耐药力;公差\r\n
tolerant	/'tɔlərənt/	a.容忍的,宽容的;有耐药力的\r\n
tolerate	/'tɔləreit/	vt.容忍,默许;对(药物、毒品等)有耐力\r\n
toll	/təul,tɔl/	n.(道路、桥等的)通行费;牺牲;死伤人数\r\n
tomato	/tə'mɑ:təu,-'mei-/	n.西红柿\r\n
tomb	/tu:m/	n.坟,冢\r\n
tomorrow	/tə'mɔrəu,-'mɔ:-/	n.明天;来日,未来ad.在明天,在明日\r\n
ton	/tʌn,tuŋ/	n.吨;(pl.)大量,许多\r\n
tone	/təun/	n.音调,音色;风气,气氛;腔调,语气;色调\r\n
tongue	/tʌŋ/	n.舌;语言\r\n
tonight	/tə'nait/	ad.在今晚;在今夜n.今晚,今夜\r\n
too	/tu:/	ad.也,还;太,过于;很,非常\r\n
tool	/tu:l/	n.工具,用具;方法,手段\r\n
tooth	/tu:θ/	n.(pl.teeth)牙齿;齿状物;\r\n
top	/tɔp/	n.顶,顶端;首位;顶点a.最高的;顶上的\r\n
topic	/'tɔpik/	n.话题,主题,题目\r\n
torch	/tɔ:tʃ/	n.手电筒;火炬,火把\r\n
torment	/tɔ:'ment,'tɔ:m-/	n.折磨;令人痛苦的东西(人)vt.折磨;纠缠\r\n
torrent	/'tɔrənt,'tɔ:-/	n.激流,洪流;爆发,(话语等的)连发\r\n
torture	/'tɔ:tʃə/	v.拷问,拷打;折磨,磨难n.拷问;折磨,痛苦\r\n
toss	/tɔs,tɔ:s/	vt.向上掷/扔;摇摆,颠簸n.投,扔;摇动\r\n
total	/'təutəl/	n.总数,合计a.总的,全部的v.合计,总数达\r\n
touch	/tʌtʃ/	v.触,碰,摸;感动;涉及n.触动,碰到;少许\r\n
tough	/tʌf/	a.坚韧的,棘手的;强健的,吃苦耐劳的;粗暴的\r\n
tour	/tuə/	n.旅游,旅行;巡回演出/比赛v.旅游\r\n
tourist	/'tuərist/	n.旅游者,观光客;巡回比赛的运动员\r\n
tow	/təu/	vt.(用绳、链等)拖(车、船等)n.拖,牵引\r\n
toward	/tə'wɔ:d/	prep.(towards)朝,向;将近;对于;为了\r\n
towel	/'tauəl/	n.毛巾vt.用毛巾擦或擦干\r\n
tower	/'tauə/	n.塔v.高耸\r\n
town	/taun/	n.市镇;市民;城市商业区,闹市区\r\n
toxic	/'tɔksik/	a.有毒的;中毒的\r\n
toy	/tɔi/	n.玩具vi.(with)漫不经心地考虑;摆弄\r\n
trace	/treis/	n.痕迹,踪迹;极少量v.描绘;跟踪,追踪\r\n
track	/træk/	n.跑道,小路;轨迹,轮迹v.跟踪,追踪\r\n
tractor	/'træktə/	n.拖拉机,牵引车\r\n
trade	/treid/	n.贸易,商业;职业,行业v.经商,交易\r\n
trademark	/'treidmɑ:k/	n.商标;特征vt.注册的…商标\r\n
tradition	/trə'diʃən/	n.传统;惯例;传说\r\n
traffic	/'træfik/	n.交通,交通量\r\n
tragedy	/'trædʒidi/	n.悲剧;惨事,灾难\r\n
tragic	/'trædʒik/	a.悲剧的,悲惨的\r\n
trail	/treil/	n.踪迹,痕迹;小路v.追踪,跟踪;拖,拖曳;\r\n
train	/trein/	n.列车;行列,系列,一串v.训练,培养\r\n
training	/'treiniŋ/	n.训练,培养\r\n
trait	/trei,treit/	n.特征,特点,特性\r\n
traitor	/'treitə/	n.叛徒,卖国贼\r\n
tram	/træm/	n.有轨电车\r\n
tramp	/træmp/	n./v步行;沉重的脚步声(走)v.践踏n.流浪者\r\n
transaction	/træn'zækʃən/	n.办理,处理;交易,事务;(pl.)会报,学报\r\n
transcend	/træn'send,trɑ:n-/	vt.超出,超越(经验、知识、能力的范围等)\r\n
transfervt.	/n.转移;转换;转让;过户;迁移;改乘\r\n
transform	/træns'fɔ:m,trænz-/	vt.改变,变换;变压;转化;改造,改造\r\n
transient	/'trænziənt,-si-/	a.短暂的,转瞬即逝的;临时的,暂住的\r\n
transistor	/træn'sistə/	n.晶体管;晶体管收音机\r\n
transition	/træn'siʒən,-'ziʃən/	n.转变,变迁,过渡(时期)\r\n
translate	/trænzˈleɪt/	v.翻译,解释;转化,\r\n
translation	/træns'leiʃən,trænz-/	n.翻译;译文,译本\r\n
transmission	/trænz'miʃən,træns-/	n.播送,发射;传动,传送\r\n
transmit	/trænz'mit,træns-/	vt.传输/导;转送;发射vi.发射信号;发报\r\n
transparent	/træns'pærənt,-'pεə-/	a.透明的,透光的;易理解的;明显的\r\n
transplant	/træns'plɑ:nt/	n./v.移植(植物;组织,器官等);迁移;\r\n
transport	/ˈtrænspɔːt , trænˈspɔːt/	v.运输,运送,搬运n.运输;运输系统,运载工具\r\n
trap	/træp/	n.陷阱,圈套vt.诱捕;使中圈套vi.设圈套\r\n
trash	/træʃ/	n.垃圾;拙劣的作品;渣滓,败类\r\n
travel	/'trævəl/	n.旅行v.旅行;行进,传播\r\n
tray	/trei/	n.盘,碟,托盘\r\n
treason	/'tri:zən/	n.谋反,通敌,叛国\r\n
treasure	/'treʒə,'trei-/	n.财宝,财富;珍品v.珍爱,珍惜\r\n
treat	/tri:t/	v.对待;治疗;论述;款待,请客n.款待,请客\r\n
treaty	/'tri:ti/	n.条约,协议,协商\r\n
tree	/tri:/	n.树,树状物vi.爬上树\r\n
tremble	/'trembl/	n.战栗,颤抖v.发抖,颤抖;摇动;焦虑\r\n
tremendous	/tri'mendəs/	a.巨大的,极大的\r\n
trench	/trentʃ/	n.&v.(挖)沟,(挖)战壕\r\n
trend	/trend/	n.倾向,趋势vi.伸向,倾向\r\n
trial	/'traiəl/	n.讯问,审讯;试验;试用;尝试\r\n
triangle	/'traiæŋɡl/	n.三角(形)\r\n
tribe	/traib/	n.种族,部落;(植物,动物)族,类\r\n
tribute	/'tribju:t/	n.贡品;颂词,称赞,(表示敬意的)礼物\r\n
trick	/trik/	n.诡计,骗局;恶作剧;窍门vt.欺骗,哄骗\r\n
trifle	/'traifl/	n.少量;小事,琐事v.玩弄;嬉耍;忽视\r\n
trigger	/'triɡə/	n.扳机vt.触发,引起\r\n
trim	/trim/	a.整齐的,整洁的v./n.整理,修整,装饰\r\n
trip	/trip/	n.旅行,远足v.绊倒;失足;犯错\r\n
triple	/'tripl/	n.三倍数a.三倍的;三部分构成的v.使成三倍\r\n
triumph	/'traiəmf,-ʌmf/	n.胜利,成功v.得胜,战胜\r\n
trivial	/'triviəl/	a.琐碎的;无足轻重的\r\n
trolley	/'trɔli/	n.手推车;(英)无轨电车,(美)有轨电车\r\n
troop	/tru:p/	n.(pl.)部队,军队;(一)群/队v.群集,集合\r\n
tropic	/'trɔpik/	n.回归线;/theT-s/热带地区\r\n
tropical	/'trɔpikəl/	a.热带的\r\n
trouble	/'trʌbl/	n.烦恼;动乱;疾病;故障;辛苦v.(使)烦恼\r\n
troublesome	/'trʌblsəm/	a.令人烦恼的,讨厌的\r\n
trousers	/'trauzəz/	n.裤子\r\n
truck	/trʌk/	n.卡车,载重汽车\r\n
TRUE	/tru:/	a.真实,不假的;忠实,可靠的;正确无误的\r\n
trumpet	/'trʌmpit/	n.喇叭,小号\r\n
trunk	/trʌŋk/	n.大衣箱,皮箱;(汽车后部)行李箱;树干,躯干\r\n
trust	/'trʌst/	vt.信任;盼望;委托n.(in)信任,依赖;委托\r\n
truth	/tru:θ/	n.真实,真相;真实性;真理\r\n
try	/trai/	v.尝试,试图;试验,试用;审讯n.尝试\r\n
tub	/tʌb/	n.木盆,澡盆\r\n
tube	/tju:b,tu:b/	n.管,软管;电子管,显像管;地铁\r\n
tuck	/tʌk/	v.卷起;塞进\r\n
Tuesday	/ˈtjuːzdeɪ/	n.星期二\r\n
tug	/tʌɡ/	v.用力拖(或拉);苦干n.拖;苦干;拖船\r\n
tuition	/tju:'iʃən/	n.学费;(某一学科的)教学,讲授,指导\r\n
tumble	/'tʌmbl/	v.(使)摔倒;打滚,翻腾n.摔跤,跌倒\r\n
tumour	/'tju:mə/	n.(tumor)(肿)瘤,肿块\r\n
tune	/tju:n,tu:n/	n.调子,曲调;和谐,协调vt.调音,调节,调整\r\n
tunnel	/'tʌnəl/	n.隧道,山洞\r\n
turbine	/'tə:bain,-bin/	n.汽轮机,涡轮机\r\n
turbulent	/'tə:bjulənt/	a.狂暴的,无秩序的\r\n
turkey	/'tə:ki/	n.火鸡(肉)\r\n
turn	/tə:n/	v./n.(使)转动;(使)旋转;(使)转变n.机会\r\n
turnover	/'tə:n,əuvə/	n.翻倒(物);人员调整;(资金等)周转;营业额\r\n
tutor	/'tju:tə/	n.导师;家庭教师v.辅导;当导师;当家庭教师\r\n
TV	/ˌtiː ˈviː/	n.(television)电视;电视机\r\n
twelve	/twelv/	num.十二pron./a.十二(个,只...)\r\n
twenty	/'twenti/	num.二十pron./a.二十(个,只...)\r\n
twice	/twais/	ad.两次,两倍\r\n
twin	/twin/	a.双的,成对的,孪生的n.孪生子,双生子\r\n
twinkle	/'twiŋkl/	vi.(星等)闪烁,(眼情)发亮n.闪烁,闪光\r\n
twist	/twist/	v.捻;拧;扭曲;蜿蜒曲折而行n.拧;歪曲;曲折\r\n
two	/tu:/	num.二,两个n.两个(人或物)\r\n
type	/taip/	n.型式,类型;印刷字体;活/铅字v.打字\r\n
typewriter	/'taip,raitə/	n.打字机\r\n
typhoon	/tai'fu:n/	n.台风\r\n
typical	/'tipikəl/	a.(of)典型的,有代表性的\r\n
typist	/'taipist/	n.打字员\r\n
ugly	/'ʌɡli/	a.丑陋的,难看的;丑恶的,讨厌的\r\n
ultimate	/'ʌltimət/	a.最后的,最终的;根本的\r\n
ultraviolet	/,ʌltrə'vaiələt/	a./n.紫外线(的)\r\n
umbrella	/ʌm'brelə/	n.伞\r\n
unanimous	/ju:'næniməs/	a.全体一致的,一致同意的\r\n
uncle	/'ʌŋkl/	n.伯父,叔父,舅父,姑父,姨父\r\n
uncover	/,ʌn'kʌvə/	v.揭开,揭露\r\n
under	/'ʌndə/	prep.在…下面;在…以下ad.在下面;少于\r\n
underestimate	/,ʌndə'estimeit/	vt.低估,看轻\r\n
undergo	/,ʌndə'ɡəu/	vt.遭受,经历,承受\r\n
undergraduate	/,ʌndə'ɡrædjuət/	n.大学生,大学肆业生\r\n
underground	/'ʌndəɡraund/	a.地下的;秘密的n.地铁ad.在地下\r\n
underlie	/,ʌndə'lai/	vt.位于...之下,成为...的基础\r\n
underline	/,ʌndə'lain,'ʌndəlain/	vt.在…下划线;强调\r\n
underlying	/,ʌndə'laiiŋ/	a.含蓄的,潜在的;在下面的\r\n
undermine	/,ʌndə'main/	v.暗中破坏,逐渐削弱;侵蚀…的基础\r\n
underneath	/,ʌndə'ni:θ/	prep.在…下面ad.在下面,在底下\r\n
understand	/,ʌndə'stænd/	v.懂,理解;获悉,听说;揣测,认为\r\n
understanding	/,ʌndə'stændiŋ/	n.理解,理解力;谅解a.了解的,通情达理的\r\n
undertake	/,ʌndə'teik/	v.承担,担任;许诺,保证;着手,从事\r\n
undo	/,ʌn'du:/	v.松开,解开\r\n
undoubtedly	/ʌnˈdaʊtɪdli/	ad.无疑,必定\r\n
uneasy	/,ʌn'i:zi/	a.不安的,焦虑的\r\n
unemployment	/,ʌnim'plɔimənt/	n.失业,失业人数\r\n
unexpected	/,ʌnik'spektid/	a.想不到的,意外的,未预料到\r\n
unfold	/,ʌn'fəuld/	vt.打开;显露;展示vi.呈现;显示;展示\r\n
unfortunately	/ʌnˈfɔːtʃənətli/	ad.不幸地\r\n
uniform	/'ju:nifɔ:m/	n.制服,军服a.相同的,一律的\r\n
unify	/'ju:nifai/	v.使联合,统一;使相同,使一致\r\n
union	/'ju:niən/	n.联合,团结;联盟,联邦;协会,社团;和谐\r\n
unique	/ju:'ni:k/	a.唯一的,独一无二的\r\n
unit	/'ju:nit/	n.单位,单元;部件,元件;机组,装置\r\n
unite	/ju:'nait/	vi.联合,团结;统一,合并vt.使联合\r\n
unity	/'ju:niti/	n.团结;统一,一致,整体\r\n
universal	/,ju:ni'və:səl/	a.普遍的,全体的,通用的;宇宙的,世界的\r\n
universe	/'ju:nivə:s/	n.宇宙,万物\r\n
university	/,ju:ni'və:səti/	n.(综合)大学\r\n
unless	/ən'les/	conj.除非prep.除…外\r\n
unlike	/,ʌn'laik/	a.不同的,不相似的prep.不象,和…不同\r\n
unlikely	/,ʌn'laikli/	a.未必的,靠不住的\r\n
unload	/,ʌn'ləud/	vi.卸货;退子弹vt.摆脱...之负担;倾销\r\n
until	/,ʌn'til/	conj.&prep.直到…为止,在…以前;直到…\r\n
unusual	/,ʌn'ju:ʒuəl/	a.不平常的,与众不同的\r\n
up	/ʌp/	ad.向上,...起来;...完;起床prep.向上\r\n
update	/ʌp'deit,'ʌpdeit/	v.更新,使现代化\r\n
upgrade	/'ʌpɡreid,ʌp'ɡreid/	v.提升,使升级\r\n
uphold	/ʌp'həuld/	vt.支持,赞成;举起;坚持\r\n
upon	/ə'pɔn/	prep.在…上;在…旁/=on/\r\n
upper	/'ʌpə/	a.上面的;上部的,较高的\r\n
upright	/'ʌprait,,ʌp'r-/	a.垂直的,直立的;正直的,诚实的ad.竖立着\r\n
uproar	/'ʌprɔ:/	n.骚动,喧嚣,鼎沸\r\n
upset	/ʌp'set,'ʌpset/	v.使…心烦意乱;打翻,推翻a.难过的;不安的\r\n
upstairs	/'ʌp'stεəz/	ad.向楼上;在楼上;上楼ad.楼上的\r\n
up-to-date	/'ʌptə'deit/	a.现代化的,最新的;跟上时代的\r\n
upward	/'ʌpwəd/	a.向上的,上升的ad.向上\r\n
urban	/'ə:bən/	a.城市的,市内的\r\n
urge	/ə:dʒ/	vt.催促;怂恿;强调n.强烈欲望,迫切要求\r\n
urgent	/'ə:dʒənt/	a.急迫的,紧要的,紧急的\r\n
us	/ʌs/	pron.我们(we的宾格形式)\r\n
usage	/'ju:zidʒ/	n.使用,用法;习惯,习俗;惯用法\r\n
use	/ju:z/	n.使/应用;用法/途;益/用处vt.用;消耗\r\n
used	/ju:zd/	a.用旧了的,旧的;习惯于…;过去惯/经常\r\n
useful	/'ju:sful/	a.有用的,实用的;有益的,有帮助的\r\n
usual	/'ju:ʒuəl/	a.通常的,平常的\r\n
usually	/ˈjuːʒuəli/	ad.通常,平常\r\n
utilize	/'ju:tilaiz/	vt.利用\r\n
utmost	/'ʌtməust/	a.最远的;极度的n.极限,极度,最大可能\r\n
utter	/'ʌtə/	v.说,发出(声音)a.彻底的,完全的\r\n
vacant	/'veikənt/	a.空的,未占用的;空缺的;神情茫然的\r\n
vacation	/və'keiʃən/	n.休假,假期\r\n
vacuum	/'vækjuəm/	n.真空,真空吸尘器\r\n
vague	/veiɡ/	a.不明确的,含糊的,暧昧的\r\n
vain	/vein/	a.徒劳的,徒然的;自负的,爱虚荣的\r\n
valid	/'vælid/	a.有效的;有根据的;正当的\r\n
valley	/'væli/	n.(山)谷;流域\r\n
valuable	/'væljuəbl/	a.贵重的,有价值的n.(pl.)贵重物品,财宝\r\n
value	/'vælju:/	n.价格;价值;实用性v.评价,估价;尊重\r\n
valve	/vælv/	n.阀;(英)电子管,真空管;(心脏的）瓣膜\r\n
van	/væn/	n.有篷汽车;有篷货运车厢\r\n
vanish	/'væniʃ/	vi.突然不见;消失\r\n
vanity	/'vænəti/	n.虚荣心,浮华\r\n
vapour	/'veipə/	n.(vapor)汽,(水)蒸气\r\n
variable	/'vεəriəbl/	a.易变的;可变的;变量的n.变量\r\n
variation	/,vεəri'eiʃən/	n.变化,变动;变种,变异\r\n
variety	/və'raiəti/	n.种种,多种多样;种类,品种\r\n
various	/'vεəriəs/	a.各种各样的;不同的\r\n
vary	/'vεəri/	vt.改变,变化;使多样化\r\n
vase	/vɑ:z,veis,veiz/	n.花瓶,瓶\r\n
vast	/vɑ:st,væst/	a.巨大的,辽阔的,大量的;巨额的\r\n
vegetable	/'vedʒitəbl/	n.蔬菜,植物a.植物的,蔬菜的\r\n
vegetarian	/,vedʒi'tεəriən/	n.素食主义者\r\n
vegetation	/,vedʒi'teiʃən/	n.植物,草木\r\n
vehicle	/'vi:ikl,有时发'vi:hi-/	n.车辆,交通工具;媒介,载体\r\n
veil	/veil/	n.面纱,遮蔽物v.用面纱掩盖,掩饰\r\n
vein	/vein/	n.血管;静脉;叶脉;纹理;情绪vt.使成脉络\r\n
velocity	/vi'lɔsəti/	n.速度,速率\r\n
velvet	/'velvit/	n.丝绒,天鹅绒a.丝绒制的,柔软的\r\n
ventilate	/'ventileit/	vt.使通风;给…装通风设备\r\n
venture	/'ventʃə/	v.冒险,拼;大胆表示n.冒险事业,拼,闯\r\n
verb	/və:b/	n.动词\r\n
verbal	/'və:bəl/	a.用言辞的,用文字的;口头的;动词的\r\n
verdict	/'və:dikt/	n.(陪审团的)裁决,判决;判断;定论\r\n
verge	/və:dʒ/	n.边,边缘v.濒临\r\n
verify	/'verifai/	vt.证实,查证;证明\r\n
versatile	/'və:sətail/	a.通用的;多才多艺的,多方面的\r\n
verse	/və:s/	n.韵文,诗;诗节,诗句\r\n
version	/'və:ʃən/	n.版本;译本,译文;说法\r\n
versus	/'və:səs/	prep.(vs.)…对…(在诉讼,比赛等);与…相对\r\n
vertical	/'və:tikəl/	a.垂直的,竖的n.垂线\r\n
very	/'veri/	ad.很,非常;完全a.正是的;真正,真实的\r\n
vessel	/'vesəl/	n.容器,器皿;船,舰;管,血管\r\n
vest	/vest/	n.背心,马甲;汗衫,内衣\r\n
veteran	/'vetərən/	n.老手,老兵\r\n
veto	/'vi:təu/	n./v.否决\r\n
via	/'vaiə/	prep.经;通过;凭借\r\n
vibrate	/vai'breit/	v.(使)振动,(使)摇摆;受…而感动\r\n
vice	/vais/	n.邪恶;恶习;(pl.)台钳,老虎钳\r\n
vicinity	/vi'sinəti/	n.邻近,附近\r\n
vicious	/'viʃəs/	a.恶毒的,凶残的,邪恶的\r\n
victim	/'viktim/	n.牺牲品,受害者\r\n
victory	/'viktəri/	n.胜利\r\n
video	/'vidiəu/	n.电视,视频;录像a.电视的,视频的;录像的\r\n
view	/vju:/	n.视野;风景;观察;见解;照片vt.观察;认为\r\n
viewpoint	/'vju:pɔint/	n.观点\r\n
vigorous	/'viɡərəs/	a.朝气蓬勃的,精力旺盛的\r\n
village	/'vilidʒ/	n.村,村庄\r\n
vinegar	/'viniɡə/	n.醋\r\n
violate	/'vaiəleit/	vt.违背;冒犯;妨碍;侵犯;亵渎(圣物)\r\n
violence	/'vaiələns/	n.猛烈,强烈;暴力,暴行;强暴\r\n
violent	/'vaiələnt/	a.猛烈的,激烈的;暴力引起的,强暴的\r\n
violet	/'vaiələt/	n.紫罗兰,紫色a.紫色的\r\n
violin	/,vaiə'lin/	n.小提琴\r\n
virgin	/'və:dʒin/	n.处女a.处女的;纯洁的;原始的;未使用的\r\n
virtual	/'və:tʃuəl/	a.实际上的,事实上的\r\n
virtue	/'və:tju:/	n.德行,美德;贞操;优点;功效,效力\r\n
virus	/'vaiərəs/	n.病毒;(精神,道德方面的)有害影响\r\n
visa	/'vi:zə/	n.(护照等的)签证;维萨信用卡vt.签证\r\n
visible	/'vizəbl/	a.看得见的,明显的,显著的\r\n
vision	/'viʒən/	n.视力,视觉;远见;洞察力;幻想,幻影;想象力\r\n
visit	/'vizit/	n.访问,参观v.访问,参观;视察;降临;闲谈\r\n
visitor	/'vizitə/	n.访问者,客人,来宾,参观者\r\n
visual	/'vizjuəl/	a.看的,看得见的;视觉的\r\n
vital	/'vaitəl/	a.生死攸关的,重大的;生命的,生机的\r\n
vitamin	/'vitəmin/	n.维生素\r\n
vivid	/'vivid/	a.鲜艳的;生动的,栩栩如生的\r\n
vocabulary	/vəu'kæbjuləri/	n.词汇,词汇量;词汇表\r\n
vocal	/'vəukəl/	a.声音的;有声的;歌唱的n.元音;声乐作品\r\n
vocation	/vəu'keiʃən/	n.职业;召唤;天命;天职;才能\r\n
voice	/vɔis/	n.声音;嗓音;发音能力;意见,发言权;语态\r\n
void	/vɔid/	a.空虚的;没有的;无效的\r\n
volcano	/vɔl'keinəu/	n.火山\r\n
volleyball	/'vɔlibɔ:l/	n.排球\r\n
volt	/vɔlt/	n.伏特\r\n
voltage	/'vəultidʒ/	n.电压\r\n
volume	/'vɔlju:m/	n.容积,体积;卷,册;音量\r\n
voluntary	/'vɔləntəri/	a.自愿的,志愿的\r\n
volunteer	/,vɔlən'tiə/	n./v.自愿(者,兵);自愿(提供)\r\n
vote	/vəut/	n.投票,表决;选票,选票数v.投票,表决\r\n
vowel	/'vauəl/	n.元音,元音字母\r\n
voyage	/'vɔiidʒ/	n.航海;航行;旅行\r\n
vulgar	/'vʌlɡə/	a.粗俗的,庸俗的,本土的,通俗的,普通的\r\n
vulnerable	/'vʌlnərəbl/	a.易受攻击的\r\n
wage	/weidʒ/	n.(常pl.)工资,报酬vt.进行,开展\r\n
wagon	/'wæɡən/	n.运货马车,运货车;敞蓬车厢\r\n
waist	/weist/	n.腰,腰部\r\n
wait	/weit/	v.(for)等待;(on)侍候n.等候,等待时间\r\n
waiter	/weitə/	n.侍者,服务员\r\n
waitress	/'weitris/	n.女侍者,女服务员\r\n
wake	/weik/	v.醒来,唤醒;使觉醒,激发,引起\r\n
waken	/'weikən/	v.醒,弄醒,唤醒\r\n
walk	/wɔ:k/	v.走,步行,散步;走遍n.走,步行,散步\r\n
wall	/wɔ:l/	n.墙,壁,围墙vt.筑墙围住,用墙隔开\r\n
wallet	/'wɔlit/	n.皮夹,钱包\r\n
wander	/'wɔndə/	v.漫步,徘徊;迷路,迷失方向;离题\r\n
want	/wɔnt,wɔ:nt/	vt.想要;希望;需要;缺,缺少n.需要;短缺\r\n
war	/wɔ:/	n.战争(状态);冲突vi.作战\r\n
ward	/wɔ:d/	n.病房;行政区;监护;被监护人vt.挡住\r\n
wardrobe	/'wɔ:drəub/	n.衣柜,衣厨;衣服;行头;剧装\r\n
warehouse	/'wεəhaus,'wεəhauz/	n.仓库,货栈\r\n
warfare	/'wɔ:fεə/	n.战争(状态);斗争;冲突\r\n
warm	/wɔ:m/	a.温暖的,热心的,热情的v.(使)变暖\r\n
warmth	/wɔ:mθ/	n.暖和,温暖;热心,热情\r\n
warn	/wɔ:n/	vt.警告vi.发出警告\r\n
warrant	/'wɔrənt,'wɔ:-/	n.正当理由;许可证,委任状v.保证,担保\r\n
wash	/wɔʃ,wɔ:ʃ/	n.洗;洗的衣物vt.冲刷,洗;冲出vi.洗澡\r\n
waste	/weist/	v.浪费a.无用的;荒芜的n.浪费;废物\r\n
watch	/wɔtʃ,wɔ:tʃ/	v.观看;看守;(for)窥伺,等待n.看管;表\r\n
watch	/wɔtʃ,wɔ:tʃ/	v.观看;注视;看守;警戒n.注视;手表;守护\r\n
water	/'wɔ:tə,'wɔ-/	n.水vt.浇灌;给…饮水vi.流泪,加水\r\n
waterfall	/'wɔ:təfɔ:l,'wɔ-/	n.瀑布\r\n
waterproof	/'wɔ:təpru:f,'wɔ-/	a.防水的,耐水的\r\n
watt	/wɔt/	n.瓦,瓦特\r\n
wave	/weiv/	n.波浪;(挥手)示意;飘扬v.(挥手)示意,致意\r\n
wax	/wæks/	n.蜡,蜂蜡v.打蜡\r\n
way	/wei/	n.道路,路程;方法/式,手段;习惯;状态\r\n
we	/wi:弱wi/	pron．我们<主格>\r\n
weak	/wi:k/	a.虚弱的,软弱的;不够标准的;淡薄的,稀的\r\n
wealth	/welθ/	n.财富,财产;大量\r\n
wealthy	/'welθi/	a.富有的,丰裕的,充分的n.富人,有钱人\r\n
weapon	/'wepən/	n.武器,兵器\r\n
wear	/'wεə/	v.穿着,戴着;磨损,用旧n.穿,戴;磨损\r\n
weary	/'wiəri/	a.疲倦的;令人厌烦的v.使疲倦,使厌倦\r\n
weather	/'weðə/	n.天气,气象\r\n
weave	/wi:v/	v.编(织)n.编织法,编织式样\r\n
web	/web/	n.网,蜘蛛网\r\n
wedding	/'wediŋ/	n.婚礼\r\n
wedge	/wedʒ/	n.楔,楔形vt.楔牢,楔入,挤进\r\n
Wednesday	/ˈwenzdeɪ/	n.星期三\r\n
weed	/wi:d/	n.杂草,野草v.除草,锄草\r\n
week	/wi:k/	n.星期,周\r\n
weekday	/'wi:kdei/	n.平常日,工作日\r\n
weekend	/,wi:k'end,'wi:kend/	n.周末\r\n
weekly	/'wi:kli/	a.每星期的,一周的ad.每周一次n.周刊,周报\r\n
weep	/wi:p/	v.哭泣,流泪;滴下n.哭泣\r\n
weigh	/wei/	v.称…重量,称;重达;考虑,权衡\r\n
weight	/weit/	n.重量;负荷,重担;重要性,分量;砝码,秤砣\r\n
weird	/wiəd/	a.古怪的,离奇的;怪诞的,神秘而可怕的\r\n
welcome	/'welkəm/	int.欢迎a.受欢迎的vt./n.欢迎;迎接\r\n
weld	/weld/	v.焊接n.焊接,焊缝\r\n
welfare	/'welfεə/	n.福利;幸福;福利事业\r\n
well	/wel/	ad.好,令人满意地;很int.哎呀,好啦,嗯\r\n
well-known	/'wel'nəun/	a.有名的,著名的\r\n
west	/west/	n./a.西,西方(的),西部(的)ad.向西\r\n
western	/'westən/	a.西方的,西部的\r\n
wet	/wet/	a.湿的,潮湿的;有雨的,多雨的v.弄湿,沾湿\r\n
whale	/hweil/	n.鲸;庞然大物\r\n
what	/hwɔt,hwʌt,弱hwət/	pron.什么a.多么,何等;什么;尽可能多的\r\n
whatever	/hwɔt'evə,'hwət-/	pron.无论什么a.无论什么样的\r\n
whatsoever	/ˌwɒtsəʊ'evə(r)/	ad.(用于否定句中以加强语气)任何\r\n
wheat	/hwi:t/	n.小麦\r\n
wheel	/hwi:l/	n.轮,车轮\r\n
when	/hwen,弱hwən/	ad./pron.何时;当时conj.那时;然后;而\r\n
whenever	/hwen'evə,hwən-/	conj.无论何时,随时;每当\r\n
where	/hwεə/	ad.在哪/那里conj./pron.哪里conj.然而\r\n
whereas	/hwεə'æz/	conj.而,却,反之\r\n
wherever	/hwεə'evə/	conj.无论在哪里ad.无论在哪里,究竟在哪里\r\n
whether	/'hweðə/	conj.是否,会不会,不管,无论\r\n
which	/hwitʃ/	a./pron.哪个,哪些;什么样的;那个,那些\r\n
whichever	/hwitʃ'evə/	pron./a.无论哪个,无论哪些\r\n
while	/hwail/	conj.当…的时候;而;虽然;尽管n.一会儿\r\n
whip	/hwip/	n.鞭子;车夫v.鞭打,抽打;突然移动\r\n
whirl	/hwə:l/	v.(使)旋转,打转n.旋转;-连串快速的活动\r\n
whisky	/'hwiski/	n.威士忌酒\r\n
whisper	/'hwispə/	v.耳语;私下说,偷偷告诉n.耳语;传闻\r\n
whistle	/'hwisl/	n.口哨,汽笛;口哨声,汽笛声v.吹口哨;鸣笛\r\n
white	/hwait/	a.白色的;苍白的;白种的n.白色;白种人\r\n
who	/hu:,弱hu,u:,u/	pron.谁,什么人;…的人;他,她,他们\r\n
whoever	/hu:'evə/	pron./引导名词从句/谁;无论谁;究竟是谁\r\n
whole	/həul/	n.全部a.全体的;全部的;完整的;无缺的\r\n
wholesome	/'həulsəm/	a.卫生的;有益的;健康的,有益健康的\r\n
wholly	/'həuli/	ad.完全地,全部,一概\r\n
whom	/hu:m,弱hum/	pron.谁;哪个人(who的宾格)\r\n
whose	/hu:z/	pron.谁的;哪(个)人的,那些(人)的\r\n
why	/hwai/	ad./conj.为什么;…的理由int.咳,哎呀\r\n
wicked	/'wikid/	a.坏的;邪恶的;不道德的;恶劣的;淘气的\r\n
wide	/waid/	a.宽阔的;睁大的;远离的ad.广阔地;偏差地\r\n
widespread	/'waid'spred/	a.分布广泛的,普遍的\r\n
widow	/'widəu/	n.寡妇\r\n
width	/widθ,witθ/	n.宽度;宽阔,广阔\r\n
wife	/waif/	n.妻子,夫人,太太\r\n
wild	/waild/	a.野性的,野生的;野蛮的;狂热的;荒芜的\r\n
will	/wil,弱wel/	aux./v.将;会;愿意n.意志;决心;愿望\r\n
willing	/'wiliŋ/	a.愿意的,乐意的,心甘情愿的\r\n
win	/win/	vi.获胜,赢vt.赢得;在…中获胜n.胜利\r\n
wind	/wind/	n.风;气息v.转动;缠绕;上发条,;蜿蜒而行\r\n
window	/'windəu/	n.窗,窗口\r\n
wine	/wain/	n.葡萄酒,果酒\r\n
wing	/wiŋ/	n.翅,翅膀;翼,机翼;派别vt.装以翼\r\n
wink	/wiŋk/	v.(使)眨眼;眨眼示意n.眨眼;小睡,打盹\r\n
winter	/'wintə/	n.冬季,冬天\r\n
wipe	/waip/	v./n.擦,揩,抹\r\n
wire	/'waiə/	n.金属线,电线;电报,电信v.发电报(给)\r\n
wisdom	/'wizdəm/	n.智慧,明智;名言,格言\r\n
wise	/waiz/	a.有智慧的,聪明的\r\n
wish	/wiʃ/	v.希望;但愿;祝n.愿望,希望;/pl./祝愿\r\n
wit	/wit/	n.智力,才智,智慧\r\n
witch	/witʃ/	n.女巫,巫婆,巫师\r\n
with	/wið,wiθ/	prep.跟…一起;用;具有;关于;因;随着\r\n
withdraw	/wið'drɔ:,wiθ-/	v.收回,撤消;缩回,退出;提取(钱)\r\n
withhold	/'wið'həuld,wiθ-/	vt.使停止;拒给;保留;抑制vi.忍住\r\n
within	/wi'ðin,wi'θin/	prep.在…里面,在…以内ad.在内\r\n
without	/wi'ðaut,-'θaut/	prep.无,没有n.外面,外部\r\n
withstand	/wið'stænd,wiθ-/	vt.抵抗,经受住\r\n
witness	/'witnis/	n.目击者,证人;证据,证明v.目击,目睹;作证\r\n
wolf	/wulf/	n.狼\r\n
woman	/'wumən/	n.(pl.）women妇女,成年女子\r\n
wonder	/'wʌndə/	n.惊奇,惊异;奇迹,奇事v.(at)诧异;想知道\r\n
wonderful	/'wʌndəful/	a.惊人的,奇妙的;极好的\r\n
wood	/wud/	n.木材,木头,木料;(pl.)森林,林地\r\n
wooden	/'wudən/	a.木制的;呆笨的\r\n
wool	/wul/	n.羊毛,毛线,毛织品\r\n
word	/wə:d/	n.词,词语;言语,话;谈话;消息,信息\r\n
work	/wə:k/	n.工作(量);作品;/pl./工厂v.工作;运转\r\n
worker	/'wə:kə/	n.工人,工作者,工作人员\r\n
workshop	/'wə:kʃɔp/	n.车间,工场,修理厂;研讨会,讲习班\r\n
world	/wə:ld/	n.世界,地球;…界,领域;世间;全世界\r\n
worldwide	/'wə:ld,waid/	a.全世界的,世界范围的ad.遍及全世界\r\n
worm	/wə:m/	n.虫,蠕虫\r\n
worry	/'wʌri,'wə:ri/	v.烦恼;(about)对…感到烦恼n.烦恼,焦虑\r\n
worse	/wə:s,'wə:s/	a./ad.更坏,更差(的/地)\r\n
worship	/'wə:ʃip/	n.礼拜,礼拜仪式;崇拜v.崇拜,敬仰;做礼拜\r\n
worst	/wə:st,'wə:st/	a./ad.最坏(的),最差(的)\r\n
worth	/wə:θ/	n.价值a.值…的,价值…的,值得…的\r\n
worthwhile	/'wə:θ'hwail/	a.值得(做)的\r\n
worthy	/'wə:ði/	a.(of)值得…的,配得上…的;有价值的\r\n
would	/wud,弱wəd/	aux./v.将;可能;将会;总是,总会;宁愿\r\n
wound	/waund/	n.创伤,伤口v.伤,伤害\r\n
wrap	/ræp/	v.裹,缠,卷,包n.披肩,围巾\r\n
wreath	/ri:θ/	n.花环,花圈\r\n
wreck	/rek/	n.失事船(或飞机)v.(船等)失事,遇难;破坏\r\n
wrench	/rentʃ/	v.猛拧;挣脱;使扭伤n.扳手;痛苦,难受\r\n
wretched	/'retʃid/	a.可怜的;悲惨的;肮脏的;恶劣的\r\n
wrinkle	/'riŋkl/	n.皱纹v.起皱,皱眉\r\n
wrist	/rist/	n.腕,腕关节\r\n
write	/rait/	v.写,书写,写字;写作;写信(给),函告\r\n
writing	/'raitiŋ/	n.写,写作;著作,作品\r\n
wrong	/rɔŋ,rɔ:ŋ/	a.错的ad.错误地,不正确地n.错误v.委屈\r\n
X-ray	/ˈeks reɪ/	n.X射线,X光\r\n
xenon	/ˈziˌnɑn/	n.氙,氙气\r\n
yard	/jɑ:d/	n.院子,场地;码\r\n
yawn	/jɔ:n/	v.打呵欠n.呵欠\r\n
year	/jə:,jiə/	n.年,年度,学年a./ad.每年,一年一次\r\n
yearly	/'jə:li,'jiə-/	a.每年的,一年一度的ad.每年,一年一次地\r\n
yell	/jel/	vi.大叫;呼喊vt.叫着说n.叫声;喊声\r\n
yellow	/'jeləu/	a.黄的,黄色的n.黄色\r\n
yes	/yes/	ad.是/用于肯定句前/,是的\r\n
yesterday	/'jestədi,-dei/	n.&ad.昨天;前不久\r\n
yet	/jet/	ad.还,尚,仍然;已经conj.然而ad.甚至\r\n
yield	/ji:ld/	v.出产,生长;(to)屈服,服从n.产量,收获\r\n
you	/ju:,弱ju,jə/	pron.你;你们;一个人,任何人\r\n
young	/jʌŋ/	a.年轻的,幼小的;没经验的n.青年人\r\n
youngster	/'jʌŋstə/	n.小伙子,年轻人;少年,儿童\r\n
your	/jɔ:,jəu,弱jə/	pron./you的所有格/你的,你们的\r\n
yours	/jɔ:z,juəz/	pron./you的物主代词/你(们)的(所有物)\r\n
yourself	/jɔ:'self,juə-,jə-/	pron./反身代词/你自己;你亲自\r\n
youth	/ju:θ/	n.青年;年轻人\r\n
zeal	/zi:l/	n.热心,热忱,热情\r\n
zebra	/'zi:brə/	n.斑马\r\n
zero	/'ziərəu,'zi:rəu/	n.零,零度num.零\r\n
zigzag	/'ziɡzæɡ/	n./a.之字形(的)v.使曲折,曲折盘旋\r\n
zinc	/ziŋk/	n.锌\r\n
zip	/zip/	v.(用拉链或像拉链那样)合上或打开\r\n
zone	/zəun/	n.地区,区域v.分区,划分地带\r\n
zoo	/zu:/	n.动物园\r\n
zoom	/zu:m/	vi.(飞机)陡升n.陡升;嗡嗡声;变焦\r\n